/	accounts.modules.views.auth.AccountLoginView	home
/__debug__/render_panel/	debug_toolbar.views.render_panel	djdt:render_panel
/__debug__/sql_explain/	debug_toolbar.panels.sql.views.sql_explain	djdt:sql_explain
/__debug__/sql_profile/	debug_toolbar.panels.sql.views.sql_profile	djdt:sql_profile
/__debug__/sql_select/	debug_toolbar.panels.sql.views.sql_select	djdt:sql_select
/__debug__/template_source/	debug_toolbar.panels.templates.views.template_source	djdt:template_source
/accounts/api/get_user/by_email	accounts.modules.api.retrieve.ApiPrivateAccountGetByEmail	api_get_user_by_email
/accounts/api/get_user/by_pk	accounts.modules.api.retrieve.ApiPrivateAccountGetByPK	api_get_user_by_pk
/accounts/api/get_user/by_username	accounts.modules.api.retrieve.ApiPublicAccountGetByUsername	api_get_user_by_username
/accounts/api/login	accounts.modules.api.auth.ApiLogin	api_login
/accounts/api/private/get_users	accounts.modules.api.retrieve.ApiAdminAccountsGetAll	api_private_get_users
/accounts/api/private/get_users/by_type	accounts.modules.api.retrieve.ApiPrivateAccountsGetByUserType	api_private_get_users_by_user_type
/accounts/api/public/get_users	accounts.modules.api.retrieve.ApiPublicAccountsGetAll	api_public_get_users
/accounts/api/public/get_users/by_parent	accounts.modules.api.retrieve.ApiPublicAccountsGetByParent	api_public_get_users_by_parent
/accounts/api/public/get_users/by_type	accounts.modules.api.retrieve.ApiPublicAccountsGetByUserType	api_public_get_users_by_user_type
/accounts/api/register	accounts.modules.api.auth.ApiRegister	api_register
/accounts/api/subuser/create	accounts.modules.api.create.ApiPatientSubAccountCreate	api_account_subuser_create
/accounts/login/	accounts.modules.views.auth.AccountLoginView	accounts_login
/accounts/logout/	accounts.modules.views.auth.AccountLogoutView	accounts_logout
/accounts/postlogin	accounts.modules.views.postlogin.PostLoginInitialView	accounts_postlogin
/accounts/register/	accounts.modules.views.auth.AccountRegistrationView	accounts_register
/album/api/private/album/toggle_privacy	albums.modules.api.update.ApiPrivateAlbumTogglePrivacy	api_private_album_toggle_privacy
/album/api/private/album/update	albums.modules.api.update.ApiPrivateAlbumUpdate	api_private_album_update
/album/api/private/albums/all	albums.modules.api.retrieve.ApiPrivateAlbumGetAlbums	api_private_albums_all
/album/api/private/create	albums.modules.api.create.ApiPrivateAlbumCreate	api_private_album_create
/album/api/private/photo/primary/detail	albums.modules.api.retrieve.ApiPrivateGetProfilePhoto	api_private_profile_photo_detail
/album/api/private/photo/set_primary	albums.modules.api.update.ApiPrivateSetPrimaryPhoto	api_private_photo_set_primary
/album/api/private/photo/toggle_privacy	albums.modules.api.update.ApiPrivatePhotoTogglePrivacy	api_private_photo_toggle_privacy
/album/api/private/photo/unset_primary	albums.modules.api.update.ApiPrivateUnsetPrimaryPhoto	api_private_photo_unset_primary
/album/api/private/photo/update	albums.modules.api.update.ApiPrivatePhotoUpdate	api_private_photo_update
/album/api/private/profile_photos/all	albums.modules.api.retrieve.ApiPrivateGetProfilePhotos	api_private_profile_photos_all
/album/api/private/upload	albums.modules.api.create.ApiPrivateAlbumPostUploadPhoto	api_private_album_post_upload_photo
/album/api/public/album/photos/all	albums.modules.api.retrieve.ApiPublicGetPhotos	api_public_album_photos_all
/album/api/public/get_album	albums.modules.api.retrieve.ApiPublicAlbumGetByPK	api_public_album_get_by_pk
/album/api/public/get_by_user	albums.modules.api.retrieve.ApiPublicAlbumsGetByUser	api_public_albums_by_profile
/apidocs/	rest_framework_swagger.views.SwaggerSchemaView
/docs/	rest_framework.schemas.views.SchemaView	api-docs:docs-index
/docs/schema.js	rest_framework.schemas.views.SchemaView	api-docs:schema-js
/doctor/analytics/checkups	doctor_profiles.modules.views.analytics.DoctorProfileAnalyticsPatientByCheckupAggregateView	doctor_profile_analytics_checkups_aggregate
/doctor/analytics/diagnoses	doctor_profiles.modules.views.analytics.DoctorProfileAnalyticsPatientByDiagnosisAggregateView	doctor_profile_analytics_diagnoses_aggregate
/doctor/analytics/findings	doctor_profiles.modules.views.analytics.DoctorProfileAnalyticsPatientByFindingAggregateView	doctor_profile_analytics_findings_aggregate
/doctor/analytics/labtests	doctor_profiles.modules.views.analytics.DoctorProfileAnalyticsPatientByLabtestAggregateView	doctor_profile_analytics_labtests_aggregate
/doctor/analytics/prescriptions	doctor_profiles.modules.views.analytics.DoctorProfileAnalyticsPatientByPrescriptionAggregateView	doctor_profile_analytics_prescriptions_aggregate
/doctor/analytics/symptoms	doctor_profiles.modules.views.analytics.DoctorProfileAnalyticsPatientBySymptomAggregateView	doctor_profile_analytics_symptoms_aggregate
/doctor/api/v1/admin/questionnaires/	rest_framework.routers.APIRootView	api-root
/doctor/api/v1/admin/questionnaires/\.<format>/	rest_framework.routers.APIRootView	api-root
/doctor/api/v1/admin/questionnaires/c/	doctor_profiles.modules.api.questionnaire_api.ChoiceViewSet	choice-list
/doctor/api/v1/admin/questionnaires/c/<pk>/	doctor_profiles.modules.api.questionnaire_api.ChoiceViewSet	choice-detail
/doctor/api/v1/admin/questionnaires/c/<pk>\.<format>/	doctor_profiles.modules.api.questionnaire_api.ChoiceViewSet	choice-detail
/doctor/api/v1/admin/questionnaires/c\.<format>/	doctor_profiles.modules.api.questionnaire_api.ChoiceViewSet	choice-list
/doctor/api/v1/admin/questionnaires/cg/	doctor_profiles.modules.api.questionnaire_api.ChoiceGroupViewSet	choicegroup-list
/doctor/api/v1/admin/questionnaires/cg/<pk>/	doctor_profiles.modules.api.questionnaire_api.ChoiceGroupViewSet	choicegroup-detail
/doctor/api/v1/admin/questionnaires/cg/<pk>\.<format>/	doctor_profiles.modules.api.questionnaire_api.ChoiceGroupViewSet	choicegroup-detail
/doctor/api/v1/admin/questionnaires/cg\.<format>/	doctor_profiles.modules.api.questionnaire_api.ChoiceGroupViewSet	choicegroup-list
/doctor/api/v1/admin/questionnaires/cgi/	doctor_profiles.modules.api.questionnaire_api.ChoiceGroupItemViewSet	choicegroupitem-list
/doctor/api/v1/admin/questionnaires/cgi/<pk>/	doctor_profiles.modules.api.questionnaire_api.ChoiceGroupItemViewSet	choicegroupitem-detail
/doctor/api/v1/admin/questionnaires/cgi/<pk>\.<format>/	doctor_profiles.modules.api.questionnaire_api.ChoiceGroupItemViewSet	choicegroupitem-detail
/doctor/api/v1/admin/questionnaires/cgi\.<format>/	doctor_profiles.modules.api.questionnaire_api.ChoiceGroupItemViewSet	choicegroupitem-list
/doctor/api/v1/admin/questionnaires/dq/	doctor_profiles.modules.api.questionnaire_api.DoctorQuestionnaireViewSet	doctorquestionnaire-list
/doctor/api/v1/admin/questionnaires/dq/<pk>/	doctor_profiles.modules.api.questionnaire_api.DoctorQuestionnaireViewSet	doctorquestionnaire-detail
/doctor/api/v1/admin/questionnaires/dq/<pk>\.<format>/	doctor_profiles.modules.api.questionnaire_api.DoctorQuestionnaireViewSet	doctorquestionnaire-detail
/doctor/api/v1/admin/questionnaires/dq\.<format>/	doctor_profiles.modules.api.questionnaire_api.DoctorQuestionnaireViewSet	doctorquestionnaire-list
/doctor/api/v1/admin/questionnaires/q/	doctor_profiles.modules.api.questionnaire_api.QuestionnaireViewSet	questionnaire-list
/doctor/api/v1/admin/questionnaires/q/<pk>/	doctor_profiles.modules.api.questionnaire_api.QuestionnaireViewSet	questionnaire-detail
/doctor/api/v1/admin/questionnaires/q/<pk>\.<format>/	doctor_profiles.modules.api.questionnaire_api.QuestionnaireViewSet	questionnaire-detail
/doctor/api/v1/admin/questionnaires/q\.<format>/	doctor_profiles.modules.api.questionnaire_api.QuestionnaireViewSet	questionnaire-list
/doctor/api/v1/admin/questionnaires/qcg/	doctor_profiles.modules.api.questionnaire_api.QuestionChoiceGroupViewSet	questionchoicegroup-list
/doctor/api/v1/admin/questionnaires/qcg/<pk>/	doctor_profiles.modules.api.questionnaire_api.QuestionChoiceGroupViewSet	questionchoicegroup-detail
/doctor/api/v1/admin/questionnaires/qcg/<pk>\.<format>/	doctor_profiles.modules.api.questionnaire_api.QuestionChoiceGroupViewSet	questionchoicegroup-detail
/doctor/api/v1/admin/questionnaires/qcg\.<format>/	doctor_profiles.modules.api.questionnaire_api.QuestionChoiceGroupViewSet	questionchoicegroup-list
/doctor/api/v1/admin/questionnaires/qq/	doctor_profiles.modules.api.questionnaire_api.QuestionViewSet	question-list
/doctor/api/v1/admin/questionnaires/qq/<pk>/	doctor_profiles.modules.api.questionnaire_api.QuestionViewSet	question-detail
/doctor/api/v1/admin/questionnaires/qq/<pk>\.<format>/	doctor_profiles.modules.api.questionnaire_api.QuestionViewSet	question-detail
/doctor/api/v1/admin/questionnaires/qq\.<format>/	doctor_profiles.modules.api.questionnaire_api.QuestionViewSet	question-list
/doctor/api/v1/admin/questionnaires/qs/	doctor_profiles.modules.api.questionnaire_api.QuestionnaireSectionViewSet	questionnairesection-list
/doctor/api/v1/admin/questionnaires/qs/<pk>/	doctor_profiles.modules.api.questionnaire_api.QuestionnaireSectionViewSet	questionnairesection-detail
/doctor/api/v1/admin/questionnaires/qs/<pk>\.<format>/	doctor_profiles.modules.api.questionnaire_api.QuestionnaireSectionViewSet	questionnairesection-detail
/doctor/api/v1/admin/questionnaires/qs\.<format>/	doctor_profiles.modules.api.questionnaire_api.QuestionnaireSectionViewSet	questionnairesection-list
/doctor/api/v1/admin/questionnaires/sq/	doctor_profiles.modules.api.questionnaire_api.SectionQuestionViewSet	sectionquestion-list
/doctor/api/v1/admin/questionnaires/sq/<pk>/	doctor_profiles.modules.api.questionnaire_api.SectionQuestionViewSet	sectionquestion-detail
/doctor/api/v1/admin/questionnaires/sq/<pk>\.<format>/	doctor_profiles.modules.api.questionnaire_api.SectionQuestionViewSet	sectionquestion-detail
/doctor/api/v1/admin/questionnaires/sq\.<format>/	doctor_profiles.modules.api.questionnaire_api.SectionQuestionViewSet	sectionquestion-list
/doctor/api/v1/analytics/agg/diagnoses/by_checkup/counts	doctor_profiles.modules.analytics_api.patient_analytics_api.ApiAnalyticsPatientByCheckupDiagnosesAggregateCounts	api_private_doctor_patient_analytics_by_diagnoses_aggregate_counts
/doctor/api/v1/analytics/agg/findings/by_checkup/counts	doctor_profiles.modules.analytics_api.patient_analytics_api.ApiAnalyticsPatientByCheckupFindingsAggregateCounts	api_private_doctor_patient_analytics_by_findings_aggregate_counts
/doctor/api/v1/analytics/agg/labtests/by_checkup/counts	doctor_profiles.modules.analytics_api.patient_analytics_api.ApiAnalyticsPatientByCheckupLabtestsAggregateCounts	api_private_doctor_patient_analytics_by_labtests_aggregate_counts
/doctor/api/v1/analytics/agg/patient/by_checkup/counts	doctor_profiles.modules.analytics_api.patient_analytics_api.ApiAnalyticsPatientByCheckupAggregateCounts	api_private_doctor_patient_analytics_by_checkup_aggregate_counts
/doctor/api/v1/analytics/agg/prescriptions/by_checkup/counts	doctor_profiles.modules.analytics_api.patient_analytics_api.ApiAnalyticsPatientByCheckupPrescriptionsAggregateCounts	api_private_doctor_patient_analytics_by_prescriptions_aggregate_counts
/doctor/api/v1/analytics/agg/symptoms/by_checkup/counts	doctor_profiles.modules.analytics_api.patient_analytics_api.ApiAnalyticsPatientByCheckupSymptomsAggregateCounts	api_private_doctor_patient_analytics_by_symptoms_aggregate_counts
/doctor/api/v1/private/appointment/create	doctor_profiles.modules.api.doctor_schedule_api.ApiDoctorScheduleAppointmentCreate	api_private_appointment_create
/doctor/api/v1/private/appointment/diagnosis/create	doctor_profiles.modules.api.diagnosis_api.ApiPrivatePatientDiagnosisCreate	api_private_appointment_diagnosis_create
/doctor/api/v1/private/appointment/diagnosis/delete	doctor_profiles.modules.api.diagnosis_api.ApiPrivatePatientDiagnosisRemove	api_private_appointment_diagnosis_delete
/doctor/api/v1/private/appointment/diagnosis/dismissed_list	doctor_profiles.modules.api.diagnosis_api.ApiPrivatePatientDismissedDiagnosisList	api_private_appointment_diagnosis_dismissed_list
/doctor/api/v1/private/appointment/diagnosis/list	doctor_profiles.modules.api.diagnosis_api.ApiPrivatePatientDiagnosisList	api_private_appointment_diagnosis_list
/doctor/api/v1/private/appointment/diagnosis/undismiss	doctor_profiles.modules.api.diagnosis_api.ApiPrivatePatientDiagnosisUndismiss	api_private_appointment_diagnosis_undismiss
/doctor/api/v1/private/appointment/finding/create	doctor_profiles.modules.api.findings_api.ApiPrivatePatientFindingCreate	api_private_appointment_finding_create
/doctor/api/v1/private/appointment/finding/delete	doctor_profiles.modules.api.findings_api.ApiPrivatePatientFindingRemove	api_private_appointment_finding_delete
/doctor/api/v1/private/appointment/finding/dismissed_list	doctor_profiles.modules.api.findings_api.ApiPrivatePatientDismissedFindingList	api_private_appointment_finding_dismissed_list
/doctor/api/v1/private/appointment/finding/list	doctor_profiles.modules.api.findings_api.ApiPrivatePatientFindingList	api_private_appointment_finding_list
/doctor/api/v1/private/appointment/finding/undismiss	doctor_profiles.modules.api.findings_api.ApiPrivatePatientFindingUndismiss	api_private_appointment_finding_undismiss
/doctor/api/v1/private/appointment/labtest/create	doctor_profiles.modules.api.labtest_api.ApiPrivatePatientLabTestCreate	api_private_patient_labtest_create
/doctor/api/v1/private/appointment/labtest/delete	doctor_profiles.modules.api.labtest_api.ApiPrivatePatientLabTestRemove	api_private_appointment_labtest_delete
/doctor/api/v1/private/appointment/labtest/dismissed_list	doctor_profiles.modules.api.labtest_api.ApiPrivatePatientDismissedLabTestList	api_private_patient_labtest_dismissed_list
/doctor/api/v1/private/appointment/labtest/list	doctor_profiles.modules.api.labtest_api.ApiPrivatePatientLabTestList	api_private_patient_labtest_list
/doctor/api/v1/private/appointment/labtest/undismiss	doctor_profiles.modules.api.labtest_api.ApiPrivatePatientLabTestUndismiss	api_private_appointment_labtest_undismiss
/doctor/api/v1/private/appointment/list	doctor_profiles.modules.api.patient_appointment_api.ApiPatientAppointmentList	api_private_patient_appointment_list
/doctor/api/v1/private/appointment/note/create	doctor_profiles.modules.api.checkup_api.ApiCheckupNoteCreate	api_private_appointment_note_create
/doctor/api/v1/private/appointment/note/list	doctor_profiles.modules.api.checkup_api.ApiCheckupNoteList	api_private_appointment_note_list
/doctor/api/v1/private/appointment/prescription/create	doctor_profiles.modules.api.prescriptions_api.ApiPrivatePrescriptionCreate	api_private_patient_prescription_create
/doctor/api/v1/private/appointment/prescription/delete	doctor_profiles.modules.api.prescriptions_api.ApiPrivatePatientPrescriptionRemove	api_private_appointment_prescription_delete
/doctor/api/v1/private/appointment/prescription/dismissed_list	doctor_profiles.modules.api.prescriptions_api.ApiPrivatePatientDismissedPrescriptionList	api_private_patient_prescription_dismissed_list
/doctor/api/v1/private/appointment/prescription/list	doctor_profiles.modules.api.prescriptions_api.ApiPrivatePatientPrescriptionList	api_private_patient_prescription_list
/doctor/api/v1/private/appointment/prescription/undismiss	doctor_profiles.modules.api.prescriptions_api.ApiPrivatePatientPrescriptionUndismiss	api_private_appointment_prescription_undismiss
/doctor/api/v1/private/appointment/status/update	doctor_profiles.modules.api.patient_appointment_api.ApiPatientAppointmentUpdateStatus	api_private_patient_appointment_status_update
/doctor/api/v1/private/appointment/symptom/create	doctor_profiles.modules.api.symptoms_api.ApiPrivatePatientSymptomCreate	api_private_appointment_symptom_create
/doctor/api/v1/private/appointment/symptom/delete	doctor_profiles.modules.api.symptoms_api.ApiPrivatePatientSymptomRemove	api_private_appointment_symptom_delete
/doctor/api/v1/private/appointment/symptom/dismissed_list	doctor_profiles.modules.api.symptoms_api.ApiPrivatePatientDismissedSymptomList	api_private_appointment_symptom_dismissed_list
/doctor/api/v1/private/appointment/symptom/list	doctor_profiles.modules.api.symptoms_api.ApiPrivatePatientSymptomList	api_private_appointment_symptom_list
/doctor/api/v1/private/appointment/symptom/undismiss	doctor_profiles.modules.api.symptoms_api.ApiPrivatePatientSymptomUndismiss	api_private_appointment_symptom_undismiss
/doctor/api/v1/private/appointments/today/count	doctor_profiles.modules.api.patient_appointment_api.ApiPatientAppointmentCount	api_private_patient_appointment_count
/doctor/api/v1/private/calendar/month	doctor_profiles.modules.api.doctor_schedule_api.ApiPrivateDoctorScheduleCalendar	api_private_calendar_month
/doctor/api/v1/private/choice_group_item/<pk>/detail	doctor_profiles.modules.api.questionnaire_api.ApiChoiceGroupItemPublicViewSet	api_public_choice_group_item_detail
/doctor/api/v1/private/choice_group_items/<pk>/delete	doctor_profiles.modules.api.questionnaire_api.ApiChoiceGroupItemPublicViewSet	api_private_choice_group_items_delete
/doctor/api/v1/private/choice_group_items/<pk>/detail	doctor_profiles.modules.api.questionnaire_api.ApiChoiceGroupItemPublicViewSet	api_private_choice_group_items_detail
/doctor/api/v1/private/choice_group_items/<pk>/update	doctor_profiles.modules.api.questionnaire_api.ApiChoiceGroupItemPublicViewSet	api_private_choice_group_items_update
/doctor/api/v1/private/choice_group_items/create	doctor_profiles.modules.api.questionnaire_api.ApiChoiceGroupItemPublicViewSet	api_private_choice_group_items_create
/doctor/api/v1/private/choice_group_items/list	doctor_profiles.modules.api.questionnaire_api.ApiChoiceGroupItemPublicViewSet	api_private_choice_group_items
/doctor/api/v1/private/choice_groups/<pk>/delete	doctor_profiles.modules.api.questionnaire_api.ApiChoiceGroupPrivateViewSet	api_private_choice_groups_delete
/doctor/api/v1/private/choice_groups/<pk>/detail	doctor_profiles.modules.api.questionnaire_api.ApiChoiceGroupPrivateViewSet	api_private_choice_groups_detail
/doctor/api/v1/private/choice_groups/<pk>/detail	doctor_profiles.modules.api.questionnaire_api.ApiChoiceGroupPublicViewSet	api_public_choice_groups_detail
/doctor/api/v1/private/choice_groups/<pk>/update	doctor_profiles.modules.api.questionnaire_api.ApiChoiceGroupPrivateViewSet	api_private_choice_groups_update
/doctor/api/v1/private/choice_groups/create	doctor_profiles.modules.api.questionnaire_api.ApiChoiceGroupPrivateViewSet	api_private_choice_groups_create
/doctor/api/v1/private/choice_groups/list	doctor_profiles.modules.api.questionnaire_api.ApiChoiceGroupPrivateViewSet	api_private_choice_groups
/doctor/api/v1/private/choices/<pk>/delete	doctor_profiles.modules.api.questionnaire_api.ApiChoicePrivateViewSet	api_private_choices_delete
/doctor/api/v1/private/choices/<pk>/detail	doctor_profiles.modules.api.questionnaire_api.ApiChoicePrivateViewSet	api_private_choices_detail
/doctor/api/v1/private/choices/<pk>/detail	doctor_profiles.modules.api.questionnaire_api.ApiChoicePublicViewSet	api_public_choices_detail
/doctor/api/v1/private/choices/<pk>/update	doctor_profiles.modules.api.questionnaire_api.ApiChoicePrivateViewSet	api_private_choices_update
/doctor/api/v1/private/choices/create	doctor_profiles.modules.api.questionnaire_api.ApiChoicePrivateViewSet	api_private_choices_create
/doctor/api/v1/private/choices/list	doctor_profiles.modules.api.questionnaire_api.ApiChoicePrivateViewSet	api_private_choices
/doctor/api/v1/private/diagnosis/create	doctor_profiles.modules.api.diagnosis_api.ApiPrivateDiagnosisCreate	api_private_diagnosis_create
/doctor/api/v1/private/doctor/schedule/create	doctor_profiles.modules.api.doctor_schedule_api.ApiDoctorScheduleCreate	api_private_doctor_schedule_create
/doctor/api/v1/private/doctor/schedule/delete	doctor_profiles.modules.api.doctor_schedule_api.ApiDoctorScheduleDelete	api_private_doctor_schedule_delete
/doctor/api/v1/private/doctor/schedule_day/delete	doctor_profiles.modules.api.doctor_schedule_api.ApiDoctorScheduleDayDelete	api_private_doctor_schedule_day_delete
/doctor/api/v1/private/doctor/schedule_day/presence/status	doctor_profiles.modules.api.doctor_schedule_api.ApiPrivateDoctorScheduleDayPresenceStatus	api_private_doctor_schedule_day_presence_status
/doctor/api/v1/private/doctor/schedule_day/presence/toggle	doctor_profiles.modules.api.doctor_schedule_api.ApiPrivateDoctorScheduleDayPresenceToggle	api_private_doctor_schedule_day_presence_toggle
/doctor/api/v1/private/doctor_association/create	doctor_profiles.modules.api.medical_associations_api.ApiPrivateDoctorAssociationCreate	api_private_doctor_association_create
/doctor/api/v1/private/doctor_association/delete	doctor_profiles.modules.api.medical_associations_api.ApiPrivateDoctorAssociationDelete	api_private_doctor_association_delete
/doctor/api/v1/private/doctor_association/detail	doctor_profiles.modules.api.medical_associations_api.ApiPrivateDoctorAssociationDetail	api_private_doctor_association_detail
/doctor/api/v1/private/doctor_association/update	doctor_profiles.modules.api.medical_associations_api.ApiPrivateDoctorAssociationUpdate	api_private_doctor_association_update
/doctor/api/v1/private/doctor_degree/create	doctor_profiles.modules.api.medical_degrees_api.ApiPrivateDoctorDegreeCreate	api_private_doctor_medical_degree_create
/doctor/api/v1/private/doctor_degree/delete	doctor_profiles.modules.api.medical_degrees_api.ApiPrivateDoctorDegreeDelete	api_private_doctor_medical_degree_delete
/doctor/api/v1/private/doctor_degree/detail	doctor_profiles.modules.api.medical_degrees_api.ApiPrivateDoctorDegreeDetail	api_private_doctor_medical_degree_detail
/doctor/api/v1/private/doctor_degree/update	doctor_profiles.modules.api.medical_degrees_api.ApiPrivateDoctorDegreeUpdate	api_private_doctor_medical_degree_update
/doctor/api/v1/private/doctor_insurance/create	doctor_profiles.modules.api.insurance_providers_api.ApiPrivateDoctorInsuranceCreate	api_private_doctor_insurance_create
/doctor/api/v1/private/doctor_insurance/delete	doctor_profiles.modules.api.insurance_providers_api.ApiPrivateDoctorInsuranceDelete	api_private_doctor_insurance_delete
/doctor/api/v1/private/doctor_insurance/detail	doctor_profiles.modules.api.insurance_providers_api.ApiPrivateDoctorInsuranceDetail	api_private_doctor_insurance_detail
/doctor/api/v1/private/doctor_insurance/update	doctor_profiles.modules.api.insurance_providers_api.ApiPrivateDoctorInsuranceUpdate	api_private_doctor_insurance_update
/doctor/api/v1/private/doctor_questionnaires/<doctor_id>/<pk>/delete	doctor_profiles.modules.api.questionnaire_api.ApiDoctorQuestionnairePrivateViewSet	api_private_doctor_questionnaires_detail
/doctor/api/v1/private/doctor_questionnaires/<doctor_id>/<pk>/detail	doctor_profiles.modules.api.questionnaire_api.ApiDoctorQuestionnairePrivateViewSet	api_private_doctor_questionnaires_detail
/doctor/api/v1/private/doctor_questionnaires/<doctor_id>/<pk>/update	doctor_profiles.modules.api.questionnaire_api.ApiDoctorQuestionnairePrivateViewSet	api_private_doctor_questionnaires_update
/doctor/api/v1/private/doctor_questionnaires/<doctor_id>/create	doctor_profiles.modules.api.questionnaire_api.ApiDoctorQuestionnairePrivateViewSet	api_private_doctor_questionnaires_create
/doctor/api/v1/private/doctor_questionnaires/<doctor_id>/list	doctor_profiles.modules.api.questionnaire_api.ApiDoctorQuestionnairePrivateViewSet	api_private_doctor_questionnaires
/doctor/api/v1/private/doctor_specialization/create	doctor_profiles.modules.api.specializations_api.ApiPrivateDoctorSpecializationCreate	api_private_doctor_specialization_create
/doctor/api/v1/private/doctor_specialization/delete	doctor_profiles.modules.api.specializations_api.ApiPrivateDoctorSpecializationDelete	api_private_doctor_specialization_delete
/doctor/api/v1/private/doctor_specialization/detail	doctor_profiles.modules.api.specializations_api.ApiPrivateDoctorSpecializationDetail	api_private_doctor_specialization_detail
/doctor/api/v1/private/doctor_specialization/update	doctor_profiles.modules.api.specializations_api.ApiPrivateDoctorSpecializationUpdate	api_private_doctor_specialization_update
/doctor/api/v1/private/finding/create	doctor_profiles.modules.api.findings_api.ApiPrivateFindingCreate	api_private_finding_create
/doctor/api/v1/private/insurance_provider/create	doctor_profiles.modules.api.insurance_providers_api.ApiPrivateInsuranceProviderCreate	api_private_insurance_provider_create
/doctor/api/v1/private/medical_association/create	doctor_profiles.modules.api.medical_associations_api.ApiPrivateMedicalAssociationCreate	api_private_medical_association_create
/doctor/api/v1/private/medical_degree/create	doctor_profiles.modules.api.medical_degrees_api.ApiPrivateMedicalDegreeCreate	api_private_medical_degree_create
/doctor/api/v1/private/medical_institution/coordinate/create	doctor_profiles.modules.api.medical_institutions_api.ApiPrivateMedicalInstitutionCoordinateCreate	api_private_medical_institution_coordinate_create
/doctor/api/v1/private/medical_institution/coordinate/vote_down	doctor_profiles.modules.api.medical_institutions_api.ApiPrivateMedicalInstitutionCoordinateVoteDown	api_private_medical_institution_coordinate_vote_down
/doctor/api/v1/private/medical_institution/coordinate/vote_up	doctor_profiles.modules.api.medical_institutions_api.ApiPrivateMedicalInstitutionCoordinateVoteUp	api_private_medical_institution_coordinate_vote_up
/doctor/api/v1/private/medical_institution/create	doctor_profiles.modules.api.medical_institutions_api.ApiPrivateMedicalInstitutionCreate	api_private_medical_institution_create
/doctor/api/v1/private/medical_institution/location/create	doctor_profiles.modules.api.medical_institutions_api.ApiPrivateMedicalInstitutionLocationCreate	api_private_medical_institution_location_create
/doctor/api/v1/private/medical_institution/location/vote_down	doctor_profiles.modules.api.medical_institutions_api.ApiPrivateMedicalInstitutionLocationVoteDown	api_private_medical_institution_location_vote_down
/doctor/api/v1/private/medical_institution/location/vote_up	doctor_profiles.modules.api.medical_institutions_api.ApiPrivateMedicalInstitutionLocationVoteUp	api_private_medical_institution_location_vote_up
/doctor/api/v1/private/medical_institution/receptionist/connected/list	doctor_profiles.modules.api.medical_institutions_api.ApiPrivateMedicalInstitutionConnectedReceptionistList	api_private_medical_institution_receptionist_connected_list
/doctor/api/v1/private/medical_institution/receptionist/list	doctor_profiles.modules.api.medical_institutions_api.ApiPrivateMedicalInstitutionReceptionistList	api_private_medical_institution_receptionist_list
/doctor/api/v1/private/medical_institution/receptionist/not_connected/list	doctor_profiles.modules.api.medical_institutions_api.ApiPrivateMedicalInstitutionNotConnectedReceptionistList	api_private_medical_institution_receptionist_not_connected_list
/doctor/api/v1/private/medical_institution_doctor/connection/create	doctor_profiles.modules.api.medical_institution_doctors_api.ApiMedicalInstitutionDoctorCreate	api_private_medical_institution_doctor_connection_create
/doctor/api/v1/private/medical_institution_doctor/list	doctor_profiles.modules.api.medical_institution_doctors_api.ApiMedicalInstitutionDoctorList	api_private_medical_institution_doctor_list
/doctor/api/v1/private/medical_institution_doctor/meta/update	doctor_profiles.modules.api.medical_institution_doctors_api.ApiMedicalInstitutionDoctorMetaUpdate	api_private_medical_institution_doctor_meta_update
/doctor/api/v1/private/notifications/appointments/clear	doctor_profiles.modules.api.doctor_notifications_api.ApiPrivateDoctorAppointmentNotificationsDelete	api_private_notifications_appointments_clear
/doctor/api/v1/private/notifications/appointments/list	doctor_profiles.modules.api.doctor_notifications_api.ApiPrivateDoctorAppointmentNotificationsList	api_private_notifications_appointments_list
/doctor/api/v1/private/patient/appointments/history	doctor_profiles.modules.api.patient_appointment_api.ApiPatientAppointmentHistory	api_private_patient_appointments_history
/doctor/api/v1/private/patients/search	doctor_profiles.modules.api.patient_connection_api.ApiPrivatePatientConnectionSearchList	api_private_patient_connection_search
/doctor/api/v1/private/prescription/detail	doctor_profiles.modules.api.prescriptions_api.ApiPrivatePatientPrescriptionDetail	api_private_prescription_detail
/doctor/api/v1/private/profile/dismiss_progress_display	doctor_profiles.modules.api.doctor_profile_api.ApiDismissProfileProgressDisplay	api_doctor_profile_dismiss_profile_progress_display
/doctor/api/v1/private/question_choice/<pk>/delete	doctor_profiles.modules.api.questionnaire_api.ApiQuestionChoiceGroupPrivateViewSet	api_private_question_choice_delete
/doctor/api/v1/private/question_choice/<pk>/detail	doctor_profiles.modules.api.questionnaire_api.ApiQuestionChoiceGroupPrivateViewSet	api_private_question_choice_detail
/doctor/api/v1/private/question_choice/<pk>/update	doctor_profiles.modules.api.questionnaire_api.ApiQuestionChoiceGroupPrivateViewSet	api_private_question_choice_update
/doctor/api/v1/private/question_choice/create	doctor_profiles.modules.api.questionnaire_api.ApiQuestionChoiceGroupPrivateViewSet	api_private_question_choice_create
/doctor/api/v1/private/question_choice/list	doctor_profiles.modules.api.questionnaire_api.ApiQuestionChoiceGroupPrivateViewSet	api_private_question_choice
/doctor/api/v1/private/question_choice_group/<pk>/detail	doctor_profiles.modules.api.questionnaire_api.ApiQuestionChoiceGroupPublicViewSet	api_public_question_choice_group_detail
/doctor/api/v1/private/questionnaires/<pk>/delete	doctor_profiles.modules.api.questionnaire_api.ApiQuestionnairePrivateViewSet	api_private_questionnaires_detail
/doctor/api/v1/private/questionnaires/<pk>/detail	doctor_profiles.modules.api.questionnaire_api.ApiQuestionnairePrivateViewSet	api_private_questionnaires_detail
/doctor/api/v1/private/questionnaires/<pk>/questions/list	doctor_profiles.modules.api.questionnaire_api.ApiQuestionsInQuestionnairePrivateView	api_private_questionnaires_questions_list
/doctor/api/v1/private/questionnaires/<pk>/update	doctor_profiles.modules.api.questionnaire_api.ApiQuestionnairePrivateViewSet	api_private_questionnaires_update
/doctor/api/v1/private/questionnaires/<questionnaire_id>/sections/<index>/delete	doctor_profiles.modules.api.questionnaire_api.ApiQuestionnaireSectionPrivateViewSet	api_private_questionnaire_section_delete
/doctor/api/v1/private/questionnaires/<questionnaire_id>/sections/<index>/detail	doctor_profiles.modules.api.questionnaire_api.ApiQuestionnaireSectionPrivateViewSet	api_private_questionnaire_section_detail
/doctor/api/v1/private/questionnaires/<questionnaire_id>/sections/<index>/update	doctor_profiles.modules.api.questionnaire_api.ApiQuestionnaireSectionPrivateViewSet	api_private_questionnaire_section_update
/doctor/api/v1/private/questionnaires/<questionnaire_id>/sections/create	doctor_profiles.modules.api.questionnaire_api.ApiQuestionnaireSectionPrivateViewSet	api_private_questionnaire_sections_create
/doctor/api/v1/private/questionnaires/<questionnaire_id>/sections/list	doctor_profiles.modules.api.questionnaire_api.ApiQuestionnaireSectionPrivateViewSet	api_private_questionnaire_sections
/doctor/api/v1/private/questionnaires/create	doctor_profiles.modules.api.questionnaire_api.ApiQuestionnairePrivateViewSet	api_private_questionnair_createes
/doctor/api/v1/private/questionnaires/list	doctor_profiles.modules.api.questionnaire_api.ApiQuestionnairePrivateViewSet	api_private_questionnaires
/doctor/api/v1/private/questions/<pk>/delete	doctor_profiles.modules.api.questionnaire_api.ApiQuestionPrivateViewSet	api_private_questions_delete
/doctor/api/v1/private/questions/<pk>/detail	doctor_profiles.modules.api.questionnaire_api.ApiQuestionPrivateViewSet	api_private_questions_detail
/doctor/api/v1/private/questions/<pk>/update	doctor_profiles.modules.api.questionnaire_api.ApiQuestionPrivateViewSet	api_private_questions_update
/doctor/api/v1/private/questions/create	doctor_profiles.modules.api.questionnaire_api.ApiQuestionPrivateViewSet	api_private_questions_create
/doctor/api/v1/private/questions/list	doctor_profiles.modules.api.questionnaire_api.ApiQuestionPrivateViewSet	api_private_questions
/doctor/api/v1/private/questions/search	doctor_profiles.modules.api.questionnaire_api.ApiQuestionSearchPrivateView	api_private_questions_search
/doctor/api/v1/private/queue/list	doctor_profiles.modules.api.doctor_schedule_api.ApiPrivateDoctorScheduleQueueList	api_private_queue_list
/doctor/api/v1/private/section_questions/<pk>/delete	doctor_profiles.modules.api.questionnaire_api.ApiSectionQuestionPrivateViewSet	api_private_section_questions_delete
/doctor/api/v1/private/section_questions/<pk>/detail	doctor_profiles.modules.api.questionnaire_api.ApiSectionQuestionPrivateViewSet	api_private_section_questions_detail
/doctor/api/v1/private/section_questions/<pk>/update	doctor_profiles.modules.api.questionnaire_api.ApiSectionQuestionPrivateViewSet	api_private_section_questions_update
/doctor/api/v1/private/section_questions/create	doctor_profiles.modules.api.questionnaire_api.ApiSectionQuestionPrivateViewSet	api_private_section_questions_create
/doctor/api/v1/private/section_questions/list	doctor_profiles.modules.api.questionnaire_api.ApiSectionQuestionPrivateViewSet	api_private_section_questions
/doctor/api/v1/private/specialization/create	doctor_profiles.modules.api.specializations_api.ApiPrivateSpecializationCreate	api_private_specialization_create
/doctor/api/v1/private/symptom/create	doctor_profiles.modules.api.symptoms_api.ApiPrivateSymptomCreate	api_private_symptom_create
/doctor/api/v1/public/choice_group_item/list	doctor_profiles.modules.api.questionnaire_api.ApiChoiceGroupItemPublicViewSet	api_public_choice_group_item
/doctor/api/v1/public/choice_groups/list	doctor_profiles.modules.api.questionnaire_api.ApiChoiceGroupPublicViewSet	api_public_choice_groups
/doctor/api/v1/public/choices/list	doctor_profiles.modules.api.questionnaire_api.ApiChoicePublicViewSet	api_public_choices
/doctor/api/v1/public/diagnoses/list	doctor_profiles.modules.api.diagnosis_api.ApiPublicDiagnosisList	api_public_diagnoses_list
/doctor/api/v1/public/doctor/schedule/days	doctor_profiles.modules.api.doctor_schedule_api.ApiDoctorScheduleDayList	api_public_doctor_schedule_days_list
/doctor/api/v1/public/doctor/schedule/list	doctor_profiles.modules.api.doctor_schedule_api.ApiDoctorScheduleList	api_public_doctor_schedule_list
/doctor/api/v1/public/doctor_association/list	doctor_profiles.modules.api.medical_associations_api.ApiPublicDoctorAssociationList	api_public_doctor_association_list
/doctor/api/v1/public/doctor_degree/list	doctor_profiles.modules.api.medical_degrees_api.ApiPublicDoctorDegreeList	api_public_doctor_medical_degree_list
/doctor/api/v1/public/doctor_insurance/list	doctor_profiles.modules.api.insurance_providers_api.ApiPublicDoctorInsuranceList	api_public_doctor_insurance_list
/doctor/api/v1/public/doctor_questionnaires/<doctor_id>/<pk>/detail	doctor_profiles.modules.api.questionnaire_api.ApiDoctorQuestionnairePublicViewSet	api_public_doctor_questionnaires_detail
/doctor/api/v1/public/doctor_questionnaires/<doctor_id>/list	doctor_profiles.modules.api.questionnaire_api.ApiDoctorQuestionnairePublicViewSet	api_public_doctor_questionnaires
/doctor/api/v1/public/doctor_specialization/list	doctor_profiles.modules.api.specializations_api.ApiPublicDoctorSpecializationList	api_public_doctor_specialization_list
/doctor/api/v1/public/findings/list	doctor_profiles.modules.api.findings_api.ApiPublicFindingList	api_public_findings_list
/doctor/api/v1/public/insurance_provider/detail	doctor_profiles.modules.api.insurance_providers_api.ApiPublicInsuranceProviderDetail	api_public_insurance_provider_detail
/doctor/api/v1/public/insurance_provider/list	doctor_profiles.modules.api.insurance_providers_api.ApiPublicInsuranceProviderList	api_public_insurance_provider_list
/doctor/api/v1/public/labtest/list	doctor_profiles.modules.api.labtest_api.ApiPublicLabtestList	api_public_labtest_list
/doctor/api/v1/public/medical_association/detail	doctor_profiles.modules.api.medical_associations_api.ApiPublicMedicalAssociationDetail	api_public_medical_association_detail
/doctor/api/v1/public/medical_association/list	doctor_profiles.modules.api.medical_associations_api.ApiPublicMedicalAssociationList	api_public_medical_association_list
/doctor/api/v1/public/medical_degree/detail	doctor_profiles.modules.api.medical_degrees_api.ApiPublicMedicalDegreeDetail	api_public_medical_degree_detail
/doctor/api/v1/public/medical_degree/list	doctor_profiles.modules.api.medical_degrees_api.ApiPublicMedicalDegreeList	api_public_medical_degree_list
/doctor/api/v1/public/medical_institution/coordinate/detail	doctor_profiles.modules.api.medical_institutions_api.ApiPublicMedicalInstitutionCoordinateDetail	api_public_medical_institution_coordinate_detail
/doctor/api/v1/public/medical_institution/coordinate/list	doctor_profiles.modules.api.medical_institutions_api.ApiPublicMedicalInstitutionCoordinateList	api_public_medical_institution_coordinate_list
/doctor/api/v1/public/medical_institution/coordinate/top/detail	doctor_profiles.modules.api.medical_institutions_api.ApiPublicMedicalInstitutionTopCoordinateDetail	api_public_medical_institution_top_coordinate_detail
/doctor/api/v1/public/medical_institution/detail	doctor_profiles.modules.api.medical_institutions_api.ApiPublicMedicalInstitutionDetail	api_public_medical_institution_detail
/doctor/api/v1/public/medical_institution/list	doctor_profiles.modules.api.medical_institutions_api.ApiPublicMedicalInstitutionList	api_public_medical_institution_list
/doctor/api/v1/public/medical_institution/location/detail	doctor_profiles.modules.api.medical_institutions_api.ApiPublicMedicalInstitutionAddressDetail	api_public_medical_institution_location_detail
/doctor/api/v1/public/medical_institution/location/list	doctor_profiles.modules.api.medical_institutions_api.ApiPublicMedicalInstitutionAddressList	api_public_medical_institution_location_list
/doctor/api/v1/public/medical_institution/location/top/detail	doctor_profiles.modules.api.medical_institutions_api.ApiPublicMedicalInstitutionTopAddressDetail	api_public_medical_institution_top_location_detail
/doctor/api/v1/public/medical_institution/type/list	doctor_profiles.modules.api.medical_institutions_api.ApiPublicMedicalInstitutionTypeList	api_public_medical_institution_type_list
/doctor/api/v1/public/medical_institution_doctor/meta/list	doctor_profiles.modules.api.medical_institution_doctors_api.ApiMedicalInstitutionDoctorMetaList	api_public_medical_institution_doctor_meta_list
/doctor/api/v1/public/medical_institutions/connected/list	doctor_profiles.modules.api.doctor_profile_api.ApiPublicDoctorProfileMedicalInstitutions	api_public_doctor_medical_institutions_list
/doctor/api/v1/public/profile/detail	doctor_profiles.modules.api.doctor_profile_api.ApiPublicDoctorProfileDetail	api_public_doctor_profile_detail
/doctor/api/v1/public/question_choice_group/list	doctor_profiles.modules.api.questionnaire_api.ApiQuestionChoiceGroupPublicViewSet	api_public_question_choice_group
/doctor/api/v1/public/questionnaires/	doctor_profiles.modules.api.questionnaire_api.ApiQuestionnairePublicViewSet	api_public_questionnaires
/doctor/api/v1/public/questionnaires/<pk>/detail	doctor_profiles.modules.api.questionnaire_api.ApiQuestionnairePublicViewSet	api_public_questionnaires_detail
/doctor/api/v1/public/questionnaires/<pk>/questions/list	doctor_profiles.modules.api.questionnaire_api.ApiQuestionsInQuestionnairePublicView	api_public_questionnaires_questions_list
/doctor/api/v1/public/questionnaires/<questionnaire_id>/sections/<index>/detail	doctor_profiles.modules.api.questionnaire_api.ApiQuestionnaireSectionPublicViewSet	api_public_questionnaire_sections_detail
/doctor/api/v1/public/questionnaires/<questionnaire_id>/sections/list	doctor_profiles.modules.api.questionnaire_api.ApiQuestionnaireSectionPublicViewSet	api_public_questionnaire_sections
/doctor/api/v1/public/questions/<pk>/detail	doctor_profiles.modules.api.questionnaire_api.ApiQuestionPublicViewSet	api_public_questions_detail
/doctor/api/v1/public/questions/list	doctor_profiles.modules.api.questionnaire_api.ApiQuestionPublicViewSet	api_public_questions
/doctor/api/v1/public/queue/list	doctor_profiles.modules.api.doctor_schedule_api.ApiPublicDummyScheduleQueueList	api_public_queue_list
/doctor/api/v1/public/section_questions/<pk>/detail	doctor_profiles.modules.api.questionnaire_api.ApiSectionQuestionPublicViewSet	api_public_section_questions_detail
/doctor/api/v1/public/section_questions/list	doctor_profiles.modules.api.questionnaire_api.ApiSectionQuestionPublicViewSet	api_public_section_questions
/doctor/api/v1/public/specialization/detail	doctor_profiles.modules.api.specializations_api.ApiPublicSpecializationDetail	api_public_specialization_detail
/doctor/api/v1/public/specialization/list	doctor_profiles.modules.api.specializations_api.ApiPublicSpecializationList	api_public_specialization_list
/doctor/api/v1/public/symptoms/list	doctor_profiles.modules.api.symptoms_api.ApiPublicSymptomList	api_public_symptoms_list
/doctor/appointments	doctor_profiles.modules.views.schedule.DoctorProfileScheduleList	doctor_profile_appointments_list
/doctor/calendar	doctor_profiles.modules.views.schedule.DoctorProfileScheduleCalendarMonth	doctor_profile_calendar
/doctor/create	doctor_profiles.modules.views.home.DoctorProfileCreate	doctor_profile_create
/doctor/home	doctor_profiles.modules.views.home.DoctorProfileHomeView	doctor_profile_home
/doctor/medical_institution/<slug>	doctor_profiles.modules.views.medical_institutions.DoctorProfileMedicalInstitutionManageConnectionView	doctor_profile_medical_institution_home
/doctor/patients	doctor_profiles.modules.views.patient.DoctorProfilePatientList	doctor_profile_patient_list
/doctor/patients/<patient_id>/detail	doctor_profiles.modules.views.patient.DoctorProfilePatientDetail	doctor_profile_patient_detail
/doctor/patients/appointment/detail	doctor_profiles.modules.views.patient.DoctorProfilePatientAppointmentDetail	doctor_profile_patient_appointment_detail
/doctor/patients/appointment/history/detail	doctor_profiles.modules.views.patient.DoctorProfilePatientAppointmentHistoryDetail	doctor_profile_patient_appointment_history_detail
/doctor/patients/detail	doctor_profiles.modules.views.patient.DoctorProfilePatientQSDetail	doctor_profile_patient_qs_detail
/doctor/queue	doctor_profiles.modules.views.schedule.DoctorProfileScheduleDetail	doctor_profile_schedule_detail_urlstring
/doctor/queue/<medical_institution>	doctor_profiles.modules.views.schedule.DoctorProfileScheduleDetail	doctor_profile_schedule_detail
/doctor/schedule/<medical_institution>	doctor_profiles.modules.views.schedule.DoctorProfileMedicalInstitutionScheduleList	doctor_profile_medical_institution_schedule_list
/doctor/schedule/<medical_institution>/history	doctor_profiles.modules.views.schedule.DoctorProfileScheduleHistory	doctor_profile_medical_institution_history_list
/doctor/settings	doctor_profiles.modules.views.settings.DoctorProfileSettingsHomeView	doctor_profile_settings_home
/doctor/settings/association	doctor_profiles.modules.views.settings.DoctorProfileAssociationSettingsView	doctor_profile_settings_association
/doctor/settings/insurance	doctor_profiles.modules.views.settings.DoctorProfileInsuranceSettingsView	doctor_profile_settings_insurance
/doctor/settings/medical_degree	doctor_profiles.modules.views.settings.DoctorProfileMedicalDegreeSettingsView	doctor_profile_settings_medical_degree
/doctor/settings/medical_institution	doctor_profiles.modules.views.medical_institutions.DoctorProfileMedicalInstitutionSettingsHomeView	doctor_profile_settings_medical_institution
/doctor/settings/medical_institution/connect	doctor_profiles.modules.views.medical_institutions.DoctorProfileMedicalInstitutionConnect	doctor_profile_settings_medical_institution_connect
/doctor/settings/medical_institution/create_connection	doctor_profiles.modules.views.medical_institutions.DoctorProfileMedicalInstitutionDoctorCreateConnection	doctor_profile_settings_medical_institution_create_connection
/doctor/settings/specialization	doctor_profiles.modules.views.settings.DoctorProfileSpecializationSettingsView	doctor_profile_settings_specialization
/doctor/snippets/profile_progress	doctor_profiles.modules.views.snippets.DoctorProfileProgressSnippet	doctor_snippets_profile_progress
/doctor/snippets/profile_progress_detail	doctor_profiles.modules.views.snippets.DoctorProfileProgressDetailSnippet	doctor_snippets_profile_progress
/drug/api/v1/private/drugs/create	drug_information.modules.api.drugs_api.ApiPrivateDrugCreate	api_private_drugs_create
/drug/api/v1/public/drug/detail	drug_information.modules.api.drugs_api.ApiPublicDrugDetail	api_public_drug_detail
/drug/api/v1/public/drug_routes/list	drug_information.modules.api.drug_routes_api.ApiDrugRouteList	api_public_drug_route_list
/drug/api/v1/public/drugs/list	drug_information.modules.api.drugs_api.ApiPublicDrugList	api_public_drugs_list
/drug/api/v1/public/generics/list	drug_information.modules.api.drugs_api.ApiPublicGenericNameList	api_public_generics_list
/location/api/v1/cities_of_province	locations.api.CitiesOfProvinceViewSet	api_location_cities_of_province
/location/api/v1/city/coordinates	locations.api.CityCoordinateView	api_location_city_coordinates
/location/api/v1/provinces_of_region/	locations.api.ProvincesofRegionViewSet	api_location_provinces_of_region
/location/api/v1/regions/	locations.api.RegionViewSet	api_location_region_list
/mHBvVWdpEY/	django.contrib.admin.sites.index	admin:index
/mHBvVWdpEY/<app_label>/	django.contrib.admin.sites.app_index	admin:app_list
/mHBvVWdpEY/account/emailaddress/	django.contrib.admin.options.changelist_view	admin:account_emailaddress_changelist
/mHBvVWdpEY/account/emailaddress/<path:object_id>/	django.views.generic.base.RedirectView
/mHBvVWdpEY/account/emailaddress/<path:object_id>/change/	django.contrib.admin.options.change_view	admin:account_emailaddress_change
/mHBvVWdpEY/account/emailaddress/<path:object_id>/delete/	django.contrib.admin.options.delete_view	admin:account_emailaddress_delete
/mHBvVWdpEY/account/emailaddress/<path:object_id>/history/	django.contrib.admin.options.history_view	admin:account_emailaddress_history
/mHBvVWdpEY/account/emailaddress/add/	django.contrib.admin.options.add_view	admin:account_emailaddress_add
/mHBvVWdpEY/account/emailaddress/autocomplete/	django.contrib.admin.options.autocomplete_view	admin:account_emailaddress_autocomplete
/mHBvVWdpEY/accounts/account/	django.contrib.admin.options.changelist_view	admin:accounts_account_changelist
/mHBvVWdpEY/accounts/account/<id>/password/	django.contrib.auth.admin.user_change_password	admin:auth_user_password_change
/mHBvVWdpEY/accounts/account/<path:object_id>/	django.views.generic.base.RedirectView
/mHBvVWdpEY/accounts/account/<path:object_id>/change/	django.contrib.admin.options.change_view	admin:accounts_account_change
/mHBvVWdpEY/accounts/account/<path:object_id>/delete/	django.contrib.admin.options.delete_view	admin:accounts_account_delete
/mHBvVWdpEY/accounts/account/<path:object_id>/history/	django.contrib.admin.options.history_view	admin:accounts_account_history
/mHBvVWdpEY/accounts/account/add/	django.contrib.auth.admin.add_view	admin:accounts_account_add
/mHBvVWdpEY/accounts/account/autocomplete/	django.contrib.admin.options.autocomplete_view	admin:accounts_account_autocomplete
/mHBvVWdpEY/albums/album/	django.contrib.admin.options.changelist_view	admin:albums_album_changelist
/mHBvVWdpEY/albums/album/<path:object_id>/	django.views.generic.base.RedirectView
/mHBvVWdpEY/albums/album/<path:object_id>/change/	django.contrib.admin.options.change_view	admin:albums_album_change
/mHBvVWdpEY/albums/album/<path:object_id>/delete/	django.contrib.admin.options.delete_view	admin:albums_album_delete
/mHBvVWdpEY/albums/album/<path:object_id>/history/	django.contrib.admin.options.history_view	admin:albums_album_history
/mHBvVWdpEY/albums/album/add/	django.contrib.admin.options.add_view	admin:albums_album_add
/mHBvVWdpEY/albums/album/autocomplete/	django.contrib.admin.options.autocomplete_view	admin:albums_album_autocomplete
/mHBvVWdpEY/albums/photo/	django.contrib.admin.options.changelist_view	admin:albums_photo_changelist
/mHBvVWdpEY/albums/photo/<path:object_id>/	django.views.generic.base.RedirectView
/mHBvVWdpEY/albums/photo/<path:object_id>/change/	django.contrib.admin.options.change_view	admin:albums_photo_change
/mHBvVWdpEY/albums/photo/<path:object_id>/delete/	django.contrib.admin.options.delete_view	admin:albums_photo_delete
/mHBvVWdpEY/albums/photo/<path:object_id>/history/	django.contrib.admin.options.history_view	admin:albums_photo_history
/mHBvVWdpEY/albums/photo/add/	django.contrib.admin.options.add_view	admin:albums_photo_add
/mHBvVWdpEY/albums/photo/autocomplete/	django.contrib.admin.options.autocomplete_view	admin:albums_photo_autocomplete
/mHBvVWdpEY/appglobals/appglobal/	django.contrib.admin.options.changelist_view	admin:appglobals_appglobal_changelist
/mHBvVWdpEY/appglobals/appglobal/<path:object_id>/	django.views.generic.base.RedirectView
/mHBvVWdpEY/appglobals/appglobal/<path:object_id>/change/	django.contrib.admin.options.change_view	admin:appglobals_appglobal_change
/mHBvVWdpEY/appglobals/appglobal/<path:object_id>/delete/	django.contrib.admin.options.delete_view	admin:appglobals_appglobal_delete
/mHBvVWdpEY/appglobals/appglobal/<path:object_id>/history/	django.contrib.admin.options.history_view	admin:appglobals_appglobal_history
/mHBvVWdpEY/appglobals/appglobal/add/	django.contrib.admin.options.add_view	admin:appglobals_appglobal_add
/mHBvVWdpEY/appglobals/appglobal/autocomplete/	django.contrib.admin.options.autocomplete_view	admin:appglobals_appglobal_autocomplete
/mHBvVWdpEY/authtoken/token/	django.contrib.admin.options.changelist_view	admin:authtoken_token_changelist
/mHBvVWdpEY/authtoken/token/<path:object_id>/	django.views.generic.base.RedirectView
/mHBvVWdpEY/authtoken/token/<path:object_id>/change/	django.contrib.admin.options.change_view	admin:authtoken_token_change
/mHBvVWdpEY/authtoken/token/<path:object_id>/delete/	django.contrib.admin.options.delete_view	admin:authtoken_token_delete
/mHBvVWdpEY/authtoken/token/<path:object_id>/history/	django.contrib.admin.options.history_view	admin:authtoken_token_history
/mHBvVWdpEY/authtoken/token/add/	django.contrib.admin.options.add_view	admin:authtoken_token_add
/mHBvVWdpEY/authtoken/token/autocomplete/	django.contrib.admin.options.autocomplete_view	admin:authtoken_token_autocomplete
/mHBvVWdpEY/biometrics/biometric/	django.contrib.admin.options.changelist_view	admin:biometrics_biometric_changelist
/mHBvVWdpEY/biometrics/biometric/<path:object_id>/	django.views.generic.base.RedirectView
/mHBvVWdpEY/biometrics/biometric/<path:object_id>/change/	django.contrib.admin.options.change_view	admin:biometrics_biometric_change
/mHBvVWdpEY/biometrics/biometric/<path:object_id>/delete/	django.contrib.admin.options.delete_view	admin:biometrics_biometric_delete
/mHBvVWdpEY/biometrics/biometric/<path:object_id>/history/	django.contrib.admin.options.history_view	admin:biometrics_biometric_history
/mHBvVWdpEY/biometrics/biometric/add/	django.contrib.admin.options.add_view	admin:biometrics_biometric_add
/mHBvVWdpEY/biometrics/biometric/autocomplete/	django.contrib.admin.options.autocomplete_view	admin:biometrics_biometric_autocomplete
/mHBvVWdpEY/datesdim/datedim/	django.contrib.admin.options.changelist_view	admin:datesdim_datedim_changelist
/mHBvVWdpEY/datesdim/datedim/<path:object_id>/	django.views.generic.base.RedirectView
/mHBvVWdpEY/datesdim/datedim/<path:object_id>/change/	django.contrib.admin.options.change_view	admin:datesdim_datedim_change
/mHBvVWdpEY/datesdim/datedim/<path:object_id>/delete/	django.contrib.admin.options.delete_view	admin:datesdim_datedim_delete
/mHBvVWdpEY/datesdim/datedim/<path:object_id>/history/	django.contrib.admin.options.history_view	admin:datesdim_datedim_history
/mHBvVWdpEY/datesdim/datedim/add/	django.contrib.admin.options.add_view	admin:datesdim_datedim_add
/mHBvVWdpEY/datesdim/datedim/autocomplete/	django.contrib.admin.options.autocomplete_view	admin:datesdim_datedim_autocomplete
/mHBvVWdpEY/doctor_profiles/choice/	django.contrib.admin.options.changelist_view	admin:doctor_profiles_choice_changelist
/mHBvVWdpEY/doctor_profiles/choice/<path:object_id>/	django.views.generic.base.RedirectView
/mHBvVWdpEY/doctor_profiles/choice/<path:object_id>/change/	django.contrib.admin.options.change_view	admin:doctor_profiles_choice_change
/mHBvVWdpEY/doctor_profiles/choice/<path:object_id>/delete/	django.contrib.admin.options.delete_view	admin:doctor_profiles_choice_delete
/mHBvVWdpEY/doctor_profiles/choice/<path:object_id>/history/	django.contrib.admin.options.history_view	admin:doctor_profiles_choice_history
/mHBvVWdpEY/doctor_profiles/choice/add/	django.contrib.admin.options.add_view	admin:doctor_profiles_choice_add
/mHBvVWdpEY/doctor_profiles/choice/autocomplete/	django.contrib.admin.options.autocomplete_view	admin:doctor_profiles_choice_autocomplete
/mHBvVWdpEY/doctor_profiles/choicegroup/	django.contrib.admin.options.changelist_view	admin:doctor_profiles_choicegroup_changelist
/mHBvVWdpEY/doctor_profiles/choicegroup/<path:object_id>/	django.views.generic.base.RedirectView
/mHBvVWdpEY/doctor_profiles/choicegroup/<path:object_id>/change/	django.contrib.admin.options.change_view	admin:doctor_profiles_choicegroup_change
/mHBvVWdpEY/doctor_profiles/choicegroup/<path:object_id>/delete/	django.contrib.admin.options.delete_view	admin:doctor_profiles_choicegroup_delete
/mHBvVWdpEY/doctor_profiles/choicegroup/<path:object_id>/history/	django.contrib.admin.options.history_view	admin:doctor_profiles_choicegroup_history
/mHBvVWdpEY/doctor_profiles/choicegroup/add/	django.contrib.admin.options.add_view	admin:doctor_profiles_choicegroup_add
/mHBvVWdpEY/doctor_profiles/choicegroup/autocomplete/	django.contrib.admin.options.autocomplete_view	admin:doctor_profiles_choicegroup_autocomplete
/mHBvVWdpEY/doctor_profiles/choicegroupitem/	django.contrib.admin.options.changelist_view	admin:doctor_profiles_choicegroupitem_changelist
/mHBvVWdpEY/doctor_profiles/choicegroupitem/<path:object_id>/	django.views.generic.base.RedirectView
/mHBvVWdpEY/doctor_profiles/choicegroupitem/<path:object_id>/change/	django.contrib.admin.options.change_view	admin:doctor_profiles_choicegroupitem_change
/mHBvVWdpEY/doctor_profiles/choicegroupitem/<path:object_id>/delete/	django.contrib.admin.options.delete_view	admin:doctor_profiles_choicegroupitem_delete
/mHBvVWdpEY/doctor_profiles/choicegroupitem/<path:object_id>/history/	django.contrib.admin.options.history_view	admin:doctor_profiles_choicegroupitem_history
/mHBvVWdpEY/doctor_profiles/choicegroupitem/add/	django.contrib.admin.options.add_view	admin:doctor_profiles_choicegroupitem_add
/mHBvVWdpEY/doctor_profiles/choicegroupitem/autocomplete/	django.contrib.admin.options.autocomplete_view	admin:doctor_profiles_choicegroupitem_autocomplete
/mHBvVWdpEY/doctor_profiles/doctordegree/	django.contrib.admin.options.changelist_view	admin:doctor_profiles_doctordegree_changelist
/mHBvVWdpEY/doctor_profiles/doctordegree/<path:object_id>/	django.views.generic.base.RedirectView
/mHBvVWdpEY/doctor_profiles/doctordegree/<path:object_id>/change/	django.contrib.admin.options.change_view	admin:doctor_profiles_doctordegree_change
/mHBvVWdpEY/doctor_profiles/doctordegree/<path:object_id>/delete/	django.contrib.admin.options.delete_view	admin:doctor_profiles_doctordegree_delete
/mHBvVWdpEY/doctor_profiles/doctordegree/<path:object_id>/history/	django.contrib.admin.options.history_view	admin:doctor_profiles_doctordegree_history
/mHBvVWdpEY/doctor_profiles/doctordegree/add/	django.contrib.admin.options.add_view	admin:doctor_profiles_doctordegree_add
/mHBvVWdpEY/doctor_profiles/doctordegree/autocomplete/	django.contrib.admin.options.autocomplete_view	admin:doctor_profiles_doctordegree_autocomplete
/mHBvVWdpEY/doctor_profiles/doctorprofile/	django.contrib.admin.options.changelist_view	admin:doctor_profiles_doctorprofile_changelist
/mHBvVWdpEY/doctor_profiles/doctorprofile/<path:object_id>/	django.views.generic.base.RedirectView
/mHBvVWdpEY/doctor_profiles/doctorprofile/<path:object_id>/change/	django.contrib.admin.options.change_view	admin:doctor_profiles_doctorprofile_change
/mHBvVWdpEY/doctor_profiles/doctorprofile/<path:object_id>/delete/	django.contrib.admin.options.delete_view	admin:doctor_profiles_doctorprofile_delete
/mHBvVWdpEY/doctor_profiles/doctorprofile/<path:object_id>/history/	django.contrib.admin.options.history_view	admin:doctor_profiles_doctorprofile_history
/mHBvVWdpEY/doctor_profiles/doctorprofile/add/	django.contrib.admin.options.add_view	admin:doctor_profiles_doctorprofile_add
/mHBvVWdpEY/doctor_profiles/doctorprofile/autocomplete/	django.contrib.admin.options.autocomplete_view	admin:doctor_profiles_doctorprofile_autocomplete
/mHBvVWdpEY/doctor_profiles/doctorquestionnaire/	django.contrib.admin.options.changelist_view	admin:doctor_profiles_doctorquestionnaire_changelist
/mHBvVWdpEY/doctor_profiles/doctorquestionnaire/<path:object_id>/	django.views.generic.base.RedirectView
/mHBvVWdpEY/doctor_profiles/doctorquestionnaire/<path:object_id>/change/	django.contrib.admin.options.change_view	admin:doctor_profiles_doctorquestionnaire_change
/mHBvVWdpEY/doctor_profiles/doctorquestionnaire/<path:object_id>/delete/	django.contrib.admin.options.delete_view	admin:doctor_profiles_doctorquestionnaire_delete
/mHBvVWdpEY/doctor_profiles/doctorquestionnaire/<path:object_id>/history/	django.contrib.admin.options.history_view	admin:doctor_profiles_doctorquestionnaire_history
/mHBvVWdpEY/doctor_profiles/doctorquestionnaire/add/	django.contrib.admin.options.add_view	admin:doctor_profiles_doctorquestionnaire_add
/mHBvVWdpEY/doctor_profiles/doctorquestionnaire/autocomplete/	django.contrib.admin.options.autocomplete_view	admin:doctor_profiles_doctorquestionnaire_autocomplete
/mHBvVWdpEY/doctor_profiles/insuranceprovider/	django.contrib.admin.options.changelist_view	admin:doctor_profiles_insuranceprovider_changelist
/mHBvVWdpEY/doctor_profiles/insuranceprovider/<path:object_id>/	django.views.generic.base.RedirectView
/mHBvVWdpEY/doctor_profiles/insuranceprovider/<path:object_id>/change/	django.contrib.admin.options.change_view	admin:doctor_profiles_insuranceprovider_change
/mHBvVWdpEY/doctor_profiles/insuranceprovider/<path:object_id>/delete/	django.contrib.admin.options.delete_view	admin:doctor_profiles_insuranceprovider_delete
/mHBvVWdpEY/doctor_profiles/insuranceprovider/<path:object_id>/history/	django.contrib.admin.options.history_view	admin:doctor_profiles_insuranceprovider_history
/mHBvVWdpEY/doctor_profiles/insuranceprovider/add/	django.contrib.admin.options.add_view	admin:doctor_profiles_insuranceprovider_add
/mHBvVWdpEY/doctor_profiles/insuranceprovider/autocomplete/	django.contrib.admin.options.autocomplete_view	admin:doctor_profiles_insuranceprovider_autocomplete
/mHBvVWdpEY/doctor_profiles/labtest/	django.contrib.admin.options.changelist_view	admin:doctor_profiles_labtest_changelist
/mHBvVWdpEY/doctor_profiles/labtest/<path:object_id>/	django.views.generic.base.RedirectView
/mHBvVWdpEY/doctor_profiles/labtest/<path:object_id>/change/	django.contrib.admin.options.change_view	admin:doctor_profiles_labtest_change
/mHBvVWdpEY/doctor_profiles/labtest/<path:object_id>/delete/	django.contrib.admin.options.delete_view	admin:doctor_profiles_labtest_delete
/mHBvVWdpEY/doctor_profiles/labtest/<path:object_id>/history/	django.contrib.admin.options.history_view	admin:doctor_profiles_labtest_history
/mHBvVWdpEY/doctor_profiles/labtest/add/	django.contrib.admin.options.add_view	admin:doctor_profiles_labtest_add
/mHBvVWdpEY/doctor_profiles/labtest/autocomplete/	django.contrib.admin.options.autocomplete_view	admin:doctor_profiles_labtest_autocomplete
/mHBvVWdpEY/doctor_profiles/medicalassociation/	django.contrib.admin.options.changelist_view	admin:doctor_profiles_medicalassociation_changelist
/mHBvVWdpEY/doctor_profiles/medicalassociation/<path:object_id>/	django.views.generic.base.RedirectView
/mHBvVWdpEY/doctor_profiles/medicalassociation/<path:object_id>/change/	django.contrib.admin.options.change_view	admin:doctor_profiles_medicalassociation_change
/mHBvVWdpEY/doctor_profiles/medicalassociation/<path:object_id>/delete/	django.contrib.admin.options.delete_view	admin:doctor_profiles_medicalassociation_delete
/mHBvVWdpEY/doctor_profiles/medicalassociation/<path:object_id>/history/	django.contrib.admin.options.history_view	admin:doctor_profiles_medicalassociation_history
/mHBvVWdpEY/doctor_profiles/medicalassociation/add/	django.contrib.admin.options.add_view	admin:doctor_profiles_medicalassociation_add
/mHBvVWdpEY/doctor_profiles/medicalassociation/autocomplete/	django.contrib.admin.options.autocomplete_view	admin:doctor_profiles_medicalassociation_autocomplete
/mHBvVWdpEY/doctor_profiles/medicaldegree/	django.contrib.admin.options.changelist_view	admin:doctor_profiles_medicaldegree_changelist
/mHBvVWdpEY/doctor_profiles/medicaldegree/<path:object_id>/	django.views.generic.base.RedirectView
/mHBvVWdpEY/doctor_profiles/medicaldegree/<path:object_id>/change/	django.contrib.admin.options.change_view	admin:doctor_profiles_medicaldegree_change
/mHBvVWdpEY/doctor_profiles/medicaldegree/<path:object_id>/delete/	django.contrib.admin.options.delete_view	admin:doctor_profiles_medicaldegree_delete
/mHBvVWdpEY/doctor_profiles/medicaldegree/<path:object_id>/history/	django.contrib.admin.options.history_view	admin:doctor_profiles_medicaldegree_history
/mHBvVWdpEY/doctor_profiles/medicaldegree/add/	django.contrib.admin.options.add_view	admin:doctor_profiles_medicaldegree_add
/mHBvVWdpEY/doctor_profiles/medicaldegree/autocomplete/	django.contrib.admin.options.autocomplete_view	admin:doctor_profiles_medicaldegree_autocomplete
/mHBvVWdpEY/doctor_profiles/medicalinstitution/	django.contrib.admin.options.changelist_view	admin:doctor_profiles_medicalinstitution_changelist
/mHBvVWdpEY/doctor_profiles/medicalinstitution/<path:object_id>/	django.views.generic.base.RedirectView
/mHBvVWdpEY/doctor_profiles/medicalinstitution/<path:object_id>/change/	django.contrib.admin.options.change_view	admin:doctor_profiles_medicalinstitution_change
/mHBvVWdpEY/doctor_profiles/medicalinstitution/<path:object_id>/delete/	django.contrib.admin.options.delete_view	admin:doctor_profiles_medicalinstitution_delete
/mHBvVWdpEY/doctor_profiles/medicalinstitution/<path:object_id>/history/	django.contrib.admin.options.history_view	admin:doctor_profiles_medicalinstitution_history
/mHBvVWdpEY/doctor_profiles/medicalinstitution/add/	django.contrib.admin.options.add_view	admin:doctor_profiles_medicalinstitution_add
/mHBvVWdpEY/doctor_profiles/medicalinstitution/autocomplete/	django.contrib.admin.options.autocomplete_view	admin:doctor_profiles_medicalinstitution_autocomplete
/mHBvVWdpEY/doctor_profiles/medicalinstitutionlocation/	django.contrib.admin.options.changelist_view	admin:doctor_profiles_medicalinstitutionlocation_changelist
/mHBvVWdpEY/doctor_profiles/medicalinstitutionlocation/<path:object_id>/	django.views.generic.base.RedirectView
/mHBvVWdpEY/doctor_profiles/medicalinstitutionlocation/<path:object_id>/change/	django.contrib.admin.options.change_view	admin:doctor_profiles_medicalinstitutionlocation_change
/mHBvVWdpEY/doctor_profiles/medicalinstitutionlocation/<path:object_id>/delete/	django.contrib.admin.options.delete_view	admin:doctor_profiles_medicalinstitutionlocation_delete
/mHBvVWdpEY/doctor_profiles/medicalinstitutionlocation/<path:object_id>/history/	django.contrib.admin.options.history_view	admin:doctor_profiles_medicalinstitutionlocation_history
/mHBvVWdpEY/doctor_profiles/medicalinstitutionlocation/add/	django.contrib.admin.options.add_view	admin:doctor_profiles_medicalinstitutionlocation_add
/mHBvVWdpEY/doctor_profiles/medicalinstitutionlocation/autocomplete/	django.contrib.admin.options.autocomplete_view	admin:doctor_profiles_medicalinstitutionlocation_autocomplete
/mHBvVWdpEY/doctor_profiles/medicalinstitutionlocationvote/	django.contrib.admin.options.changelist_view	admin:doctor_profiles_medicalinstitutionlocationvote_changelist
/mHBvVWdpEY/doctor_profiles/medicalinstitutionlocationvote/<path:object_id>/	django.views.generic.base.RedirectView
/mHBvVWdpEY/doctor_profiles/medicalinstitutionlocationvote/<path:object_id>/change/	django.contrib.admin.options.change_view	admin:doctor_profiles_medicalinstitutionlocationvote_change
/mHBvVWdpEY/doctor_profiles/medicalinstitutionlocationvote/<path:object_id>/delete/	django.contrib.admin.options.delete_view	admin:doctor_profiles_medicalinstitutionlocationvote_delete
/mHBvVWdpEY/doctor_profiles/medicalinstitutionlocationvote/<path:object_id>/history/	django.contrib.admin.options.history_view	admin:doctor_profiles_medicalinstitutionlocationvote_history
/mHBvVWdpEY/doctor_profiles/medicalinstitutionlocationvote/add/	django.contrib.admin.options.add_view	admin:doctor_profiles_medicalinstitutionlocationvote_add
/mHBvVWdpEY/doctor_profiles/medicalinstitutionlocationvote/autocomplete/	django.contrib.admin.options.autocomplete_view	admin:doctor_profiles_medicalinstitutionlocationvote_autocomplete
/mHBvVWdpEY/doctor_profiles/medicalinstitutionphone/	django.contrib.admin.options.changelist_view	admin:doctor_profiles_medicalinstitutionphone_changelist
/mHBvVWdpEY/doctor_profiles/medicalinstitutionphone/<path:object_id>/	django.views.generic.base.RedirectView
/mHBvVWdpEY/doctor_profiles/medicalinstitutionphone/<path:object_id>/change/	django.contrib.admin.options.change_view	admin:doctor_profiles_medicalinstitutionphone_change
/mHBvVWdpEY/doctor_profiles/medicalinstitutionphone/<path:object_id>/delete/	django.contrib.admin.options.delete_view	admin:doctor_profiles_medicalinstitutionphone_delete
/mHBvVWdpEY/doctor_profiles/medicalinstitutionphone/<path:object_id>/history/	django.contrib.admin.options.history_view	admin:doctor_profiles_medicalinstitutionphone_history
/mHBvVWdpEY/doctor_profiles/medicalinstitutionphone/add/	django.contrib.admin.options.add_view	admin:doctor_profiles_medicalinstitutionphone_add
/mHBvVWdpEY/doctor_profiles/medicalinstitutionphone/autocomplete/	django.contrib.admin.options.autocomplete_view	admin:doctor_profiles_medicalinstitutionphone_autocomplete
/mHBvVWdpEY/doctor_profiles/medicalinstitutionphonevote/	django.contrib.admin.options.changelist_view	admin:doctor_profiles_medicalinstitutionphonevote_changelist
/mHBvVWdpEY/doctor_profiles/medicalinstitutionphonevote/<path:object_id>/	django.views.generic.base.RedirectView
/mHBvVWdpEY/doctor_profiles/medicalinstitutionphonevote/<path:object_id>/change/	django.contrib.admin.options.change_view	admin:doctor_profiles_medicalinstitutionphonevote_change
/mHBvVWdpEY/doctor_profiles/medicalinstitutionphonevote/<path:object_id>/delete/	django.contrib.admin.options.delete_view	admin:doctor_profiles_medicalinstitutionphonevote_delete
/mHBvVWdpEY/doctor_profiles/medicalinstitutionphonevote/<path:object_id>/history/	django.contrib.admin.options.history_view	admin:doctor_profiles_medicalinstitutionphonevote_history
/mHBvVWdpEY/doctor_profiles/medicalinstitutionphonevote/add/	django.contrib.admin.options.add_view	admin:doctor_profiles_medicalinstitutionphonevote_add
/mHBvVWdpEY/doctor_profiles/medicalinstitutionphonevote/autocomplete/	django.contrib.admin.options.autocomplete_view	admin:doctor_profiles_medicalinstitutionphonevote_autocomplete
/mHBvVWdpEY/doctor_profiles/medicalinstitutiontype/	django.contrib.admin.options.changelist_view	admin:doctor_profiles_medicalinstitutiontype_changelist
/mHBvVWdpEY/doctor_profiles/medicalinstitutiontype/<path:object_id>/	django.views.generic.base.RedirectView
/mHBvVWdpEY/doctor_profiles/medicalinstitutiontype/<path:object_id>/change/	django.contrib.admin.options.change_view	admin:doctor_profiles_medicalinstitutiontype_change
/mHBvVWdpEY/doctor_profiles/medicalinstitutiontype/<path:object_id>/delete/	django.contrib.admin.options.delete_view	admin:doctor_profiles_medicalinstitutiontype_delete
/mHBvVWdpEY/doctor_profiles/medicalinstitutiontype/<path:object_id>/history/	django.contrib.admin.options.history_view	admin:doctor_profiles_medicalinstitutiontype_history
/mHBvVWdpEY/doctor_profiles/medicalinstitutiontype/add/	django.contrib.admin.options.add_view	admin:doctor_profiles_medicalinstitutiontype_add
/mHBvVWdpEY/doctor_profiles/medicalinstitutiontype/autocomplete/	django.contrib.admin.options.autocomplete_view	admin:doctor_profiles_medicalinstitutiontype_autocomplete
/mHBvVWdpEY/doctor_profiles/question/	django.contrib.admin.options.changelist_view	admin:doctor_profiles_question_changelist
/mHBvVWdpEY/doctor_profiles/question/<path:object_id>/	django.views.generic.base.RedirectView
/mHBvVWdpEY/doctor_profiles/question/<path:object_id>/change/	django.contrib.admin.options.change_view	admin:doctor_profiles_question_change
/mHBvVWdpEY/doctor_profiles/question/<path:object_id>/delete/	django.contrib.admin.options.delete_view	admin:doctor_profiles_question_delete
/mHBvVWdpEY/doctor_profiles/question/<path:object_id>/history/	django.contrib.admin.options.history_view	admin:doctor_profiles_question_history
/mHBvVWdpEY/doctor_profiles/question/add/	django.contrib.admin.options.add_view	admin:doctor_profiles_question_add
/mHBvVWdpEY/doctor_profiles/question/autocomplete/	django.contrib.admin.options.autocomplete_view	admin:doctor_profiles_question_autocomplete
/mHBvVWdpEY/doctor_profiles/questionchoicegroup/	django.contrib.admin.options.changelist_view	admin:doctor_profiles_questionchoicegroup_changelist
/mHBvVWdpEY/doctor_profiles/questionchoicegroup/<path:object_id>/	django.views.generic.base.RedirectView
/mHBvVWdpEY/doctor_profiles/questionchoicegroup/<path:object_id>/change/	django.contrib.admin.options.change_view	admin:doctor_profiles_questionchoicegroup_change
/mHBvVWdpEY/doctor_profiles/questionchoicegroup/<path:object_id>/delete/	django.contrib.admin.options.delete_view	admin:doctor_profiles_questionchoicegroup_delete
/mHBvVWdpEY/doctor_profiles/questionchoicegroup/<path:object_id>/history/	django.contrib.admin.options.history_view	admin:doctor_profiles_questionchoicegroup_history
/mHBvVWdpEY/doctor_profiles/questionchoicegroup/add/	django.contrib.admin.options.add_view	admin:doctor_profiles_questionchoicegroup_add
/mHBvVWdpEY/doctor_profiles/questionchoicegroup/autocomplete/	django.contrib.admin.options.autocomplete_view	admin:doctor_profiles_questionchoicegroup_autocomplete
/mHBvVWdpEY/doctor_profiles/questionnaire/	django.contrib.admin.options.changelist_view	admin:doctor_profiles_questionnaire_changelist
/mHBvVWdpEY/doctor_profiles/questionnaire/<path:object_id>/	django.views.generic.base.RedirectView
/mHBvVWdpEY/doctor_profiles/questionnaire/<path:object_id>/change/	django.contrib.admin.options.change_view	admin:doctor_profiles_questionnaire_change
/mHBvVWdpEY/doctor_profiles/questionnaire/<path:object_id>/delete/	django.contrib.admin.options.delete_view	admin:doctor_profiles_questionnaire_delete
/mHBvVWdpEY/doctor_profiles/questionnaire/<path:object_id>/history/	django.contrib.admin.options.history_view	admin:doctor_profiles_questionnaire_history
/mHBvVWdpEY/doctor_profiles/questionnaire/add/	django.contrib.admin.options.add_view	admin:doctor_profiles_questionnaire_add
/mHBvVWdpEY/doctor_profiles/questionnaire/autocomplete/	django.contrib.admin.options.autocomplete_view	admin:doctor_profiles_questionnaire_autocomplete
/mHBvVWdpEY/doctor_profiles/questionnairesection/	django.contrib.admin.options.changelist_view	admin:doctor_profiles_questionnairesection_changelist
/mHBvVWdpEY/doctor_profiles/questionnairesection/<path:object_id>/	django.views.generic.base.RedirectView
/mHBvVWdpEY/doctor_profiles/questionnairesection/<path:object_id>/change/	django.contrib.admin.options.change_view	admin:doctor_profiles_questionnairesection_change
/mHBvVWdpEY/doctor_profiles/questionnairesection/<path:object_id>/delete/	django.contrib.admin.options.delete_view	admin:doctor_profiles_questionnairesection_delete
/mHBvVWdpEY/doctor_profiles/questionnairesection/<path:object_id>/history/	django.contrib.admin.options.history_view	admin:doctor_profiles_questionnairesection_history
/mHBvVWdpEY/doctor_profiles/questionnairesection/add/	django.contrib.admin.options.add_view	admin:doctor_profiles_questionnairesection_add
/mHBvVWdpEY/doctor_profiles/questionnairesection/autocomplete/	django.contrib.admin.options.autocomplete_view	admin:doctor_profiles_questionnairesection_autocomplete
/mHBvVWdpEY/doctor_profiles/sectionquestion/	django.contrib.admin.options.changelist_view	admin:doctor_profiles_sectionquestion_changelist
/mHBvVWdpEY/doctor_profiles/sectionquestion/<path:object_id>/	django.views.generic.base.RedirectView
/mHBvVWdpEY/doctor_profiles/sectionquestion/<path:object_id>/change/	django.contrib.admin.options.change_view	admin:doctor_profiles_sectionquestion_change
/mHBvVWdpEY/doctor_profiles/sectionquestion/<path:object_id>/delete/	django.contrib.admin.options.delete_view	admin:doctor_profiles_sectionquestion_delete
/mHBvVWdpEY/doctor_profiles/sectionquestion/<path:object_id>/history/	django.contrib.admin.options.history_view	admin:doctor_profiles_sectionquestion_history
/mHBvVWdpEY/doctor_profiles/sectionquestion/add/	django.contrib.admin.options.add_view	admin:doctor_profiles_sectionquestion_add
/mHBvVWdpEY/doctor_profiles/sectionquestion/autocomplete/	django.contrib.admin.options.autocomplete_view	admin:doctor_profiles_sectionquestion_autocomplete
/mHBvVWdpEY/doctor_profiles/specialization/	django.contrib.admin.options.changelist_view	admin:doctor_profiles_specialization_changelist
/mHBvVWdpEY/doctor_profiles/specialization/<path:object_id>/	django.views.generic.base.RedirectView
/mHBvVWdpEY/doctor_profiles/specialization/<path:object_id>/change/	django.contrib.admin.options.change_view	admin:doctor_profiles_specialization_change
/mHBvVWdpEY/doctor_profiles/specialization/<path:object_id>/delete/	django.contrib.admin.options.delete_view	admin:doctor_profiles_specialization_delete
/mHBvVWdpEY/doctor_profiles/specialization/<path:object_id>/history/	django.contrib.admin.options.history_view	admin:doctor_profiles_specialization_history
/mHBvVWdpEY/doctor_profiles/specialization/add/	django.contrib.admin.options.add_view	admin:doctor_profiles_specialization_add
/mHBvVWdpEY/doctor_profiles/specialization/autocomplete/	django.contrib.admin.options.autocomplete_view	admin:doctor_profiles_specialization_autocomplete
/mHBvVWdpEY/jsi18n/	django.contrib.admin.sites.i18n_javascript	admin:jsi18n
/mHBvVWdpEY/locations/barangay/	django.contrib.admin.options.changelist_view	admin:locations_barangay_changelist
/mHBvVWdpEY/locations/barangay/<path:object_id>/	django.views.generic.base.RedirectView
/mHBvVWdpEY/locations/barangay/<path:object_id>/change/	django.contrib.admin.options.change_view	admin:locations_barangay_change
/mHBvVWdpEY/locations/barangay/<path:object_id>/delete/	django.contrib.admin.options.delete_view	admin:locations_barangay_delete
/mHBvVWdpEY/locations/barangay/<path:object_id>/history/	django.contrib.admin.options.history_view	admin:locations_barangay_history
/mHBvVWdpEY/locations/barangay/add/	django.contrib.admin.options.add_view	admin:locations_barangay_add
/mHBvVWdpEY/locations/barangay/autocomplete/	django.contrib.admin.options.autocomplete_view	admin:locations_barangay_autocomplete
/mHBvVWdpEY/locations/barangaycoordinate/	django.contrib.admin.options.changelist_view	admin:locations_barangaycoordinate_changelist
/mHBvVWdpEY/locations/barangaycoordinate/<path:object_id>/	django.views.generic.base.RedirectView
/mHBvVWdpEY/locations/barangaycoordinate/<path:object_id>/change/	django.contrib.admin.options.change_view	admin:locations_barangaycoordinate_change
/mHBvVWdpEY/locations/barangaycoordinate/<path:object_id>/delete/	django.contrib.admin.options.delete_view	admin:locations_barangaycoordinate_delete
/mHBvVWdpEY/locations/barangaycoordinate/<path:object_id>/history/	django.contrib.admin.options.history_view	admin:locations_barangaycoordinate_history
/mHBvVWdpEY/locations/barangaycoordinate/add/	django.contrib.admin.options.add_view	admin:locations_barangaycoordinate_add
/mHBvVWdpEY/locations/barangaycoordinate/autocomplete/	django.contrib.admin.options.autocomplete_view	admin:locations_barangaycoordinate_autocomplete
/mHBvVWdpEY/locations/city/	django.contrib.admin.options.changelist_view	admin:locations_city_changelist
/mHBvVWdpEY/locations/city/<path:object_id>/	django.views.generic.base.RedirectView
/mHBvVWdpEY/locations/city/<path:object_id>/change/	django.contrib.admin.options.change_view	admin:locations_city_change
/mHBvVWdpEY/locations/city/<path:object_id>/delete/	django.contrib.admin.options.delete_view	admin:locations_city_delete
/mHBvVWdpEY/locations/city/<path:object_id>/history/	django.contrib.admin.options.history_view	admin:locations_city_history
/mHBvVWdpEY/locations/city/add/	django.contrib.admin.options.add_view	admin:locations_city_add
/mHBvVWdpEY/locations/city/autocomplete/	django.contrib.admin.options.autocomplete_view	admin:locations_city_autocomplete
/mHBvVWdpEY/locations/citycoordinate/	django.contrib.admin.options.changelist_view	admin:locations_citycoordinate_changelist
/mHBvVWdpEY/locations/citycoordinate/<path:object_id>/	django.views.generic.base.RedirectView
/mHBvVWdpEY/locations/citycoordinate/<path:object_id>/change/	django.contrib.admin.options.change_view	admin:locations_citycoordinate_change
/mHBvVWdpEY/locations/citycoordinate/<path:object_id>/delete/	django.contrib.admin.options.delete_view	admin:locations_citycoordinate_delete
/mHBvVWdpEY/locations/citycoordinate/<path:object_id>/history/	django.contrib.admin.options.history_view	admin:locations_citycoordinate_history
/mHBvVWdpEY/locations/citycoordinate/add/	django.contrib.admin.options.add_view	admin:locations_citycoordinate_add
/mHBvVWdpEY/locations/citycoordinate/autocomplete/	django.contrib.admin.options.autocomplete_view	admin:locations_citycoordinate_autocomplete
/mHBvVWdpEY/locations/country/	django.contrib.admin.options.changelist_view	admin:locations_country_changelist
/mHBvVWdpEY/locations/country/<path:object_id>/	django.views.generic.base.RedirectView
/mHBvVWdpEY/locations/country/<path:object_id>/change/	django.contrib.admin.options.change_view	admin:locations_country_change
/mHBvVWdpEY/locations/country/<path:object_id>/delete/	django.contrib.admin.options.delete_view	admin:locations_country_delete
/mHBvVWdpEY/locations/country/<path:object_id>/history/	django.contrib.admin.options.history_view	admin:locations_country_history
/mHBvVWdpEY/locations/country/add/	django.contrib.admin.options.add_view	admin:locations_country_add
/mHBvVWdpEY/locations/country/autocomplete/	django.contrib.admin.options.autocomplete_view	admin:locations_country_autocomplete
/mHBvVWdpEY/locations/province/	django.contrib.admin.options.changelist_view	admin:locations_province_changelist
/mHBvVWdpEY/locations/province/<path:object_id>/	django.views.generic.base.RedirectView
/mHBvVWdpEY/locations/province/<path:object_id>/change/	django.contrib.admin.options.change_view	admin:locations_province_change
/mHBvVWdpEY/locations/province/<path:object_id>/delete/	django.contrib.admin.options.delete_view	admin:locations_province_delete
/mHBvVWdpEY/locations/province/<path:object_id>/history/	django.contrib.admin.options.history_view	admin:locations_province_history
/mHBvVWdpEY/locations/province/add/	django.contrib.admin.options.add_view	admin:locations_province_add
/mHBvVWdpEY/locations/province/autocomplete/	django.contrib.admin.options.autocomplete_view	admin:locations_province_autocomplete
/mHBvVWdpEY/locations/provincecoordinate/	django.contrib.admin.options.changelist_view	admin:locations_provincecoordinate_changelist
/mHBvVWdpEY/locations/provincecoordinate/<path:object_id>/	django.views.generic.base.RedirectView
/mHBvVWdpEY/locations/provincecoordinate/<path:object_id>/change/	django.contrib.admin.options.change_view	admin:locations_provincecoordinate_change
/mHBvVWdpEY/locations/provincecoordinate/<path:object_id>/delete/	django.contrib.admin.options.delete_view	admin:locations_provincecoordinate_delete
/mHBvVWdpEY/locations/provincecoordinate/<path:object_id>/history/	django.contrib.admin.options.history_view	admin:locations_provincecoordinate_history
/mHBvVWdpEY/locations/provincecoordinate/add/	django.contrib.admin.options.add_view	admin:locations_provincecoordinate_add
/mHBvVWdpEY/locations/provincecoordinate/autocomplete/	django.contrib.admin.options.autocomplete_view	admin:locations_provincecoordinate_autocomplete
/mHBvVWdpEY/locations/region/	django.contrib.admin.options.changelist_view	admin:locations_region_changelist
/mHBvVWdpEY/locations/region/<path:object_id>/	django.views.generic.base.RedirectView
/mHBvVWdpEY/locations/region/<path:object_id>/change/	django.contrib.admin.options.change_view	admin:locations_region_change
/mHBvVWdpEY/locations/region/<path:object_id>/delete/	django.contrib.admin.options.delete_view	admin:locations_region_delete
/mHBvVWdpEY/locations/region/<path:object_id>/history/	django.contrib.admin.options.history_view	admin:locations_region_history
/mHBvVWdpEY/locations/region/add/	django.contrib.admin.options.add_view	admin:locations_region_add
/mHBvVWdpEY/locations/region/autocomplete/	django.contrib.admin.options.autocomplete_view	admin:locations_region_autocomplete
/mHBvVWdpEY/locations/regioncoordinate/	django.contrib.admin.options.changelist_view	admin:locations_regioncoordinate_changelist
/mHBvVWdpEY/locations/regioncoordinate/<path:object_id>/	django.views.generic.base.RedirectView
/mHBvVWdpEY/locations/regioncoordinate/<path:object_id>/change/	django.contrib.admin.options.change_view	admin:locations_regioncoordinate_change
/mHBvVWdpEY/locations/regioncoordinate/<path:object_id>/delete/	django.contrib.admin.options.delete_view	admin:locations_regioncoordinate_delete
/mHBvVWdpEY/locations/regioncoordinate/<path:object_id>/history/	django.contrib.admin.options.history_view	admin:locations_regioncoordinate_history
/mHBvVWdpEY/locations/regioncoordinate/add/	django.contrib.admin.options.add_view	admin:locations_regioncoordinate_add
/mHBvVWdpEY/locations/regioncoordinate/autocomplete/	django.contrib.admin.options.autocomplete_view	admin:locations_regioncoordinate_autocomplete
/mHBvVWdpEY/login/	django.contrib.admin.sites.login	admin:login
/mHBvVWdpEY/logout/	django.contrib.admin.sites.logout	admin:logout
/mHBvVWdpEY/password_change/	django.contrib.admin.sites.password_change	admin:password_change
/mHBvVWdpEY/password_change/done/	django.contrib.admin.sites.password_change_done	admin:password_change_done
/mHBvVWdpEY/profiles/baseprofile/	django.contrib.admin.options.changelist_view	admin:profiles_baseprofile_changelist
/mHBvVWdpEY/profiles/baseprofile/<path:object_id>/	django.views.generic.base.RedirectView
/mHBvVWdpEY/profiles/baseprofile/<path:object_id>/change/	django.contrib.admin.options.change_view	admin:profiles_baseprofile_change
/mHBvVWdpEY/profiles/baseprofile/<path:object_id>/delete/	django.contrib.admin.options.delete_view	admin:profiles_baseprofile_delete
/mHBvVWdpEY/profiles/baseprofile/<path:object_id>/history/	django.contrib.admin.options.history_view	admin:profiles_baseprofile_history
/mHBvVWdpEY/profiles/baseprofile/add/	django.contrib.admin.options.add_view	admin:profiles_baseprofile_add
/mHBvVWdpEY/profiles/baseprofile/autocomplete/	django.contrib.admin.options.autocomplete_view	admin:profiles_baseprofile_autocomplete
/mHBvVWdpEY/profiles/gender/	django.contrib.admin.options.changelist_view	admin:profiles_gender_changelist
/mHBvVWdpEY/profiles/gender/<path:object_id>/	django.views.generic.base.RedirectView
/mHBvVWdpEY/profiles/gender/<path:object_id>/change/	django.contrib.admin.options.change_view	admin:profiles_gender_change
/mHBvVWdpEY/profiles/gender/<path:object_id>/delete/	django.contrib.admin.options.delete_view	admin:profiles_gender_delete
/mHBvVWdpEY/profiles/gender/<path:object_id>/history/	django.contrib.admin.options.history_view	admin:profiles_gender_history
/mHBvVWdpEY/profiles/gender/add/	django.contrib.admin.options.add_view	admin:profiles_gender_add
/mHBvVWdpEY/profiles/gender/autocomplete/	django.contrib.admin.options.autocomplete_view	admin:profiles_gender_autocomplete
/mHBvVWdpEY/profiles/profilephone/	django.contrib.admin.options.changelist_view	admin:profiles_profilephone_changelist
/mHBvVWdpEY/profiles/profilephone/<path:object_id>/	django.views.generic.base.RedirectView
/mHBvVWdpEY/profiles/profilephone/<path:object_id>/change/	django.contrib.admin.options.change_view	admin:profiles_profilephone_change
/mHBvVWdpEY/profiles/profilephone/<path:object_id>/delete/	django.contrib.admin.options.delete_view	admin:profiles_profilephone_delete
/mHBvVWdpEY/profiles/profilephone/<path:object_id>/history/	django.contrib.admin.options.history_view	admin:profiles_profilephone_history
/mHBvVWdpEY/profiles/profilephone/add/	django.contrib.admin.options.add_view	admin:profiles_profilephone_add
/mHBvVWdpEY/profiles/profilephone/autocomplete/	django.contrib.admin.options.autocomplete_view	admin:profiles_profilephone_autocomplete
/mHBvVWdpEY/r/<int:content_type_id>/<path:object_id>/	django.contrib.contenttypes.views.shortcut	admin:view_on_site
/mHBvVWdpEY/sites/site/	django.contrib.admin.options.changelist_view	admin:sites_site_changelist
/mHBvVWdpEY/sites/site/<path:object_id>/	django.views.generic.base.RedirectView
/mHBvVWdpEY/sites/site/<path:object_id>/change/	django.contrib.admin.options.change_view	admin:sites_site_change
/mHBvVWdpEY/sites/site/<path:object_id>/delete/	django.contrib.admin.options.delete_view	admin:sites_site_delete
/mHBvVWdpEY/sites/site/<path:object_id>/history/	django.contrib.admin.options.history_view	admin:sites_site_history
/mHBvVWdpEY/sites/site/add/	django.contrib.admin.options.add_view	admin:sites_site_add
/mHBvVWdpEY/sites/site/autocomplete/	django.contrib.admin.options.autocomplete_view	admin:sites_site_autocomplete
/mHBvVWdpEY/socialaccount/socialaccount/	django.contrib.admin.options.changelist_view	admin:socialaccount_socialaccount_changelist
/mHBvVWdpEY/socialaccount/socialaccount/<path:object_id>/	django.views.generic.base.RedirectView
/mHBvVWdpEY/socialaccount/socialaccount/<path:object_id>/change/	django.contrib.admin.options.change_view	admin:socialaccount_socialaccount_change
/mHBvVWdpEY/socialaccount/socialaccount/<path:object_id>/delete/	django.contrib.admin.options.delete_view	admin:socialaccount_socialaccount_delete
/mHBvVWdpEY/socialaccount/socialaccount/<path:object_id>/history/	django.contrib.admin.options.history_view	admin:socialaccount_socialaccount_history
/mHBvVWdpEY/socialaccount/socialaccount/add/	django.contrib.admin.options.add_view	admin:socialaccount_socialaccount_add
/mHBvVWdpEY/socialaccount/socialaccount/autocomplete/	django.contrib.admin.options.autocomplete_view	admin:socialaccount_socialaccount_autocomplete
/mHBvVWdpEY/socialaccount/socialapp/	django.contrib.admin.options.changelist_view	admin:socialaccount_socialapp_changelist
/mHBvVWdpEY/socialaccount/socialapp/<path:object_id>/	django.views.generic.base.RedirectView
/mHBvVWdpEY/socialaccount/socialapp/<path:object_id>/change/	django.contrib.admin.options.change_view	admin:socialaccount_socialapp_change
/mHBvVWdpEY/socialaccount/socialapp/<path:object_id>/delete/	django.contrib.admin.options.delete_view	admin:socialaccount_socialapp_delete
/mHBvVWdpEY/socialaccount/socialapp/<path:object_id>/history/	django.contrib.admin.options.history_view	admin:socialaccount_socialapp_history
/mHBvVWdpEY/socialaccount/socialapp/add/	django.contrib.admin.options.add_view	admin:socialaccount_socialapp_add
/mHBvVWdpEY/socialaccount/socialapp/autocomplete/	django.contrib.admin.options.autocomplete_view	admin:socialaccount_socialapp_autocomplete
/mHBvVWdpEY/socialaccount/socialtoken/	django.contrib.admin.options.changelist_view	admin:socialaccount_socialtoken_changelist
/mHBvVWdpEY/socialaccount/socialtoken/<path:object_id>/	django.views.generic.base.RedirectView
/mHBvVWdpEY/socialaccount/socialtoken/<path:object_id>/change/	django.contrib.admin.options.change_view	admin:socialaccount_socialtoken_change
/mHBvVWdpEY/socialaccount/socialtoken/<path:object_id>/delete/	django.contrib.admin.options.delete_view	admin:socialaccount_socialtoken_delete
/mHBvVWdpEY/socialaccount/socialtoken/<path:object_id>/history/	django.contrib.admin.options.history_view	admin:socialaccount_socialtoken_history
/mHBvVWdpEY/socialaccount/socialtoken/add/	django.contrib.admin.options.add_view	admin:socialaccount_socialtoken_add
/mHBvVWdpEY/socialaccount/socialtoken/autocomplete/	django.contrib.admin.options.autocomplete_view	admin:socialaccount_socialtoken_autocomplete
/mHBvVWdpEY/taggit/tag/	django.contrib.admin.options.changelist_view	admin:taggit_tag_changelist
/mHBvVWdpEY/taggit/tag/<path:object_id>/	django.views.generic.base.RedirectView
/mHBvVWdpEY/taggit/tag/<path:object_id>/change/	django.contrib.admin.options.change_view	admin:taggit_tag_change
/mHBvVWdpEY/taggit/tag/<path:object_id>/delete/	django.contrib.admin.options.delete_view	admin:taggit_tag_delete
/mHBvVWdpEY/taggit/tag/<path:object_id>/history/	django.contrib.admin.options.history_view	admin:taggit_tag_history
/mHBvVWdpEY/taggit/tag/add/	django.contrib.admin.options.add_view	admin:taggit_tag_add
/mHBvVWdpEY/taggit/tag/autocomplete/	django.contrib.admin.options.autocomplete_view	admin:taggit_tag_autocomplete
/policy/	accounts.modules.views.auth.AccountLoginView	policy
/policy/	django.views.generic.base.TemplateView
/profile/albums/<id>/detail	profiles.modules.views.albums.BaseProfileAlbumDetail	profile_album_detail
/profile/albums/list	profiles.modules.views.albums.BaseProfileAlbumList	profile_album_list
/profile/api/private/profile/update	profiles.modules.api.update.ApiPrivateProfileUpdate	api_private_profile_update
/profile/api/private/profiles/by_name	profiles.modules.api.retrieve.ApiPrivateProfilesGetByName	api_private_profiles_by_name
/profile/api/public/cover_photos/album	profiles.modules.api.retrieve.ApiPublicProfileGetCoverPhotoAlbum	api_public_cover_photo_album
/profile/api/public/profile/by_pk	profiles.modules.api.retrieve.ApiPrivateProfileGetByPK	api_private_profile_by_pk
/profile/api/public/profile/by_pk	profiles.modules.api.retrieve.ApiPublicProfileGetByPK	api_public_profile_by_pk
/profile/api/public/profile/by_username	profiles.modules.api.retrieve.ApiPublicProfileGetByUsername	api_public_profile_by_username
/profile/api/public/profile_photos/album	profiles.modules.api.retrieve.ApiPublicProfileGetProfilePhotoAlbum	api_public_profile_photo_album
/profile/api/public/profiles/by_user_type	profiles.modules.api.retrieve.ApiPublicProfileGetByUserType	api_public_profiles_by_user_type
/profile/home	profiles.modules.views.home.BaseProfileHomeView	base_profile_home_view
/profile/settings/basic	profiles.modules.views.settings.ProfileSettingsBasicInfoView	profile_settings_basic_info_view
/profile/settings/biometrics/create	profiles.modules.views.settings.BiometricsCreateView	profile_settings_biometrics_create
/profile/settings/biometrics/update	profiles.modules.views.settings.BiometricsUpdateView	profile_settings_biometrics_update
/profile/settings/email	profiles.modules.views.settings.ProfileSettingsEmailView	profile_settings_email_view
/profile/settings/password	profiles.modules.views.settings.ProfileSettingsPasswordView	profile_settings_password_view
/receptionist/api/v1/private/connection/create	receptionist_profiles.modules.api.receptionist_profile_api.ApiPrivateReceptionistConnectionCreate	api_private_receptionist_connection_create
/receptionist/api/v1/private/connection/delete	receptionist_profiles.modules.api.receptionist_profile_api.ApiPrivateReceptionistConnectionDelete	api_private_receptionist_connection_delete
/receptionist/api/v1/private/connection/list	receptionist_profiles.modules.api.receptionist_connections_api.ApiPrivateReceptionistProfileConnectionList	api_private_receptionist_connection_list
/receptionist/api/v1/private/medical_institution/create	doctor_profiles.modules.api.medical_institutions_api.ApiPrivateMedicalInstitutionCreate	api_private_medical_institution_create_by_receptionist
/receptionist/api/v1/private/profile/create_by_doctor	receptionist_profiles.modules.api.receptionist_profile_api.ApiPrivateReceptionistProfileCreateByDoctor	api_private_receptionist_profile_create_by_doctor
/receptionist/calendar/<doctor_id>	receptionist_profiles.modules.views.doctor_schedule.ReceptionistProfileDoctorScheduleCalendarMonth	receptionist_profile_doctor_calendar_month
/receptionist/create	receptionist_profiles.modules.views.home.ReceptionistProfileCreate	receptionist_profile_create
/receptionist/home	receptionist_profiles.modules.views.home.ReceptionistProfileHomeView	receptionist_profile_home
/receptionist/medical_institution/<slug>	receptionist_profiles.modules.views.receptionist_connections.ReceptionistProfileMedicalInstitutionManageConnectionView	receptionist_profile_medical_institution_home
/receptionist/medical_institution/<slug>/remove	receptionist_profiles.modules.views.receptionist_connections.ReceptionistProfileRemoveConnectionView	receptionist_profile_medical_intitution_remove
/receptionist/patients/<patient_id>/detail	receptionist_profiles.modules.views.patient.ReceptionistProfilePatientDetail	receptionist_profile_patient_detail
/receptionist/queue/<medical_institution>/<doctor_id>	receptionist_profiles.modules.views.doctor_schedule.ReceptionistProfileDoctorScheduleDetail	receptionist_profile_doctor_queue
/receptionist/schedule/<medical_institution>/<doctor>/history	receptionist_profiles.modules.views.doctor_schedule.DoctorProfileScheduleHistory	receptionist_profile_medical_institution_doctor_history_list
/receptionist/schedule/<medical_institution>/<doctor_id>	receptionist_profiles.modules.views.doctor_schedule.ReceptionistProfileDoctorScheduleList	receptionist_profile_doctor_schedules
/receptionist/settings/medical_institution	receptionist_profiles.modules.views.receptionist_connections.ReceptionistProfileMedicalInstitutionSettingsHomeView	receptionist_profile_settings_medical_institution
/receptionist/settings/medical_institution/connect	receptionist_profiles.modules.views.receptionist_connections.ReceptionistMedicalInstitutionConnect	receptionist_profile_settings_medical_institution_connect
/receptionist/settings/medical_institution/create_connection	receptionist_profiles.modules.views.receptionist_connections.ReceptionistProfileMedicalInstitutionCreateConnection	receptionist_profile_settings_medical_institution_create_connection
/rest-auth/facebook	accounts.modules.api.auth.ApiFacebookLogin	api_facebook_login
/rest-auth/login/	rest_auth.views.LoginView	rest_login
/rest-auth/logout/	rest_auth.views.LogoutView	rest_logout
/rest-auth/password/change/	rest_auth.views.PasswordChangeView	rest_password_change
/rest-auth/password/reset/	rest_auth.views.PasswordResetView	rest_password_reset
/rest-auth/password/reset/confirm/	rest_auth.views.PasswordResetConfirmView	rest_password_reset_confirm
/rest-auth/registration/	rest_auth.registration.views.RegisterView	rest_register
/rest-auth/registration/account-confirm-email/<key>/	django.views.generic.base.TemplateView	account_confirm_email
/rest-auth/registration/verify-email/	rest_auth.registration.views.VerifyEmailView	rest_verify_email
/rest-auth/user/	rest_auth.views.UserDetailsView	rest_user_details
/search/	rest_framework.routers.APIRootView	api-root
/search/\.<format>/	rest_framework.routers.APIRootView	api-root
/search/api/v1/doctors	search_indexes.modules.api.doctor_api.ApiElasticSearchDoctorLookup	api_es_doctors_search
/search/api/v1/drugs	search_indexes.modules.api.drug_api.ApiElasticSearchDrugLookup	api_es_drugs_search
/search/doctors/	search_indexes.modules.api.doctor_viewsets.BaseDoctorDocumentViewSet	doctordocument-list
/search/doctors/<id>/	search_indexes.modules.api.doctor_viewsets.BaseDoctorDocumentViewSet	doctordocument-detail
/search/doctors/<id>\.<format>/	search_indexes.modules.api.doctor_viewsets.BaseDoctorDocumentViewSet	doctordocument-detail
/search/doctors\.<format>/	search_indexes.modules.api.doctor_viewsets.BaseDoctorDocumentViewSet	doctordocument-list
/search/drugs/	search_indexes.modules.api.drug_viewsets.BaseDrugDocumentViewSet	drugdocument-list
/search/drugs/<id>/	search_indexes.modules.api.drug_viewsets.BaseDrugDocumentViewSet	drugdocument-detail
/search/drugs/<id>\.<format>/	search_indexes.modules.api.drug_viewsets.BaseDrugDocumentViewSet	drugdocument-detail
/search/drugs\.<format>/	search_indexes.modules.api.drug_viewsets.BaseDrugDocumentViewSet	drugdocument-list
/social/confirm-email/	allauth.account.views.EmailVerificationSentView	account_email_verification_sent
/social/confirm-email/<key>/	allauth.account.views.ConfirmEmailView	account_confirm_email
/social/email/	allauth.account.views.EmailView	account_email
/social/facebook/login/	allauth.socialaccount.providers.oauth2.views.view	facebook_login
/social/facebook/login/callback/	allauth.socialaccount.providers.oauth2.views.view	facebook_callback
/social/facebook/login/token/	allauth.socialaccount.providers.facebook.views.login_by_token	facebook_login_by_token
/social/google/login/	allauth.socialaccount.providers.oauth2.views.view	google_login
/social/google/login/callback/	allauth.socialaccount.providers.oauth2.views.view	google_callback
/social/inactive/	allauth.account.views.AccountInactiveView	account_inactive
/social/login/	allauth.account.views.LoginView	account_login
/social/logout/	allauth.account.views.LogoutView	account_logout
/social/password/change/	allauth.account.views.PasswordChangeView	account_change_password
/social/password/reset/	allauth.account.views.PasswordResetView	account_reset_password
/social/password/reset/done/	allauth.account.views.PasswordResetDoneView	account_reset_password_done
/social/password/reset/key/<uidb36>-<key>/	allauth.account.views.PasswordResetFromKeyView	account_reset_password_from_key
/social/password/reset/key/done/	allauth.account.views.PasswordResetFromKeyDoneView	account_reset_password_from_key_done
/social/password/set/	allauth.account.views.PasswordSetView	account_set_password
/social/signup/	allauth.account.views.SignupView	account_signup
/social/social/connections/	allauth.socialaccount.views.ConnectionsView	socialaccount_connections
/social/social/login/cancelled/	allauth.socialaccount.views.LoginCancelledView	socialaccount_login_cancelled
/social/social/login/error/	allauth.socialaccount.views.LoginErrorView	socialaccount_login_error
/social/social/signup/	allauth.socialaccount.views.SignupView	socialaccount_signup
/terms/	accounts.modules.views.auth.AccountLoginView	terms
/terms/	django.views.generic.base.TemplateView
